char_length,word_length,baidu_vertical_types_number,baidu_vertical_results_number,baidu_vertical_results_area_fraction,baidu_total_images_number,baidu_total_images_area_fraction,sogou_vertical_types_number,sogou_vertical_results_number,sogou_vertical_results_area_fraction,sogou_total_images_number,sogou_total_images_area_fraction,delta_vertical_types_number,delta_vertical_results_number,delta_vertical_results_area_fraction,delta_total_images_number,delta_total_images_area_fraction,preference
30,4,3,5,0.610555050045,0,0.0,1,3,0.398815399803,0,0.0,2,2,0.211739650243,0,0.0,different
12,2,5,8,0.883000688231,5,0.0661699803253,4,8,0.860353130016,2,0.0291959725668,1,0,0.0226475582152,3,0.0369740077585,different
24,4,3,7,0.741784037559,6,0.0950311534635,2,5,0.5203969129,0,0.0,1,2,0.221387124659,6,0.0950311534635,tie
27,5,2,5,0.581460674157,3,0.0473821060106,5,8,0.843243243243,0,0.0,-3,-3,-0.261782569086,3,0.0473821060106,tie
18,3,2,9,0.921369102683,9,0.143765754551,3,6,0.656465942744,1,0.0151916001077,-1,3,0.264903159938,8,0.128574154443,tie
8,2,4,9,0.927101200686,10,0.164147436347,5,10,1.0,14,0.191219860689,-1,-1,-0.0728987993139,-4,-0.0270724243424,different
18,3,2,3,0.335758835759,2,0.0350686688977,3,7,0.75023923445,0,0.0,-1,-4,-0.414480398691,2,0.0350686688977,tie
11,2,3,9,0.92389380531,9,0.154449452249,4,10,1.0,5,0.0904150197628,-1,-1,-0.0761061946903,4,0.0640344324857,different
21,4,2,5,0.554780876494,3,0.0504024793021,3,5,0.53276047261,0,0.0,-1,0,0.0220204038839,3,0.0504024793021,tie
27,5,2,4,0.42889137738,0,0.0,4,6,0.680147058824,0,0.0,-2,-2,-0.251255681444,0,0.0,different
22,4,4,10,1.0,12,0.132275593853,3,10,1.0,2,0.0341863274016,1,0,0.0,10,0.0980892664512,tie
21,5,2,6,0.663366336634,5,0.0835050977217,2,7,0.730123180291,0,0.0,0,-1,-0.0667568436575,5,0.0835050977217,tie
24,5,3,6,0.675572519084,4,0.0656694287579,4,7,0.77519379845,1,0.0156667449691,-1,-1,-0.0996212793656,3,0.0500026837888,tie
21,4,3,5,0.616079494128,2,0.0337259010756,3,6,0.768463073852,7,0.081623419827,0,-1,-0.152383579724,-5,-0.0478975187514,different
27,5,3,3,0.392236976507,2,0.045027358924,5,8,0.853535353535,5,0.0858891949801,-2,-5,-0.461298377029,-3,-0.0408618360561,different
12,2,4,7,0.790296052632,3,0.0565966787321,5,8,0.896674584323,6,0.0565720146837,-1,-1,-0.106378531691,-3,2.46640484927e-05,tie
9,2,5,8,0.865079365079,3,0.0458739009854,4,8,0.929268292683,0,0.0,1,0,-0.0641889276036,3,0.0458739009854,tie
21,3,5,9,0.940434477926,7,0.106543219847,2,7,0.793973941368,2,0.0315368670418,3,2,0.146460536558,5,0.0750063528049,tie
21,4,2,4,0.468,2,0.0337360594796,3,3,0.453321364452,4,0.106962624449,-1,1,0.0146786355476,-2,-0.0732265649696,tie
18,3,4,8,0.872563718141,14,0.208064183522,4,9,0.926952141058,1,0.0152721166323,0,-1,-0.054388422917,13,0.192792066889,tie
21,4,6,10,1.0,13,0.226401452831,6,8,0.865740740741,5,0.0964590347924,0,2,0.134259259259,8,0.129942418039,different
15,3,4,10,1.0,9,0.142139691164,5,9,0.939541348158,5,0.0693663528966,-1,1,0.0604586518416,4,0.0727733382673,different
27,4,4,5,0.629045643154,7,0.172048003208,3,4,0.590266875981,2,0.0682802911374,1,1,0.0387787671724,5,0.103767712071,tie
21,3,4,9,0.931561996779,11,0.175001047597,4,9,0.936123348018,10,0.174435989854,0,0,-0.00456135123823,1,0.000565057742321,different
24,3,3,6,0.704604691573,4,0.0717139452036,4,7,0.751191611058,0,0.0,-1,-1,-0.0465869194856,4,0.0717139452036,different
35,9,3,7,0.744700460829,4,0.0621862847549,2,8,0.847368421053,0,0.0,1,-1,-0.102667960223,4,0.0621862847549,different
12,2,3,4,0.468196037539,4,0.074109105287,3,3,0.458141674333,1,0.0167332943046,0,1,0.0100543632061,3,0.0573758109824,tie
19,3,3,8,0.854824935952,20,0.296081892323,3,9,0.937768240343,14,0.366247886591,0,-1,-0.0829433043912,6,-0.0701659942678,different
36,7,3,6,0.722817764165,0,0.0,1,5,0.616740088106,0,0.0,2,1,0.10607767606,0,0.0,tie
24,4,4,10,1.0,14,0.199098188813,4,8,0.85266723116,0,0.0,0,2,0.14733276884,14,0.199098188813,tie
24,4,2,4,0.499058380414,2,0.0317665343499,3,9,0.928512736237,0,0.0,-1,-5,-0.429454355822,2,0.0317665343499,tie
32,9,2,6,0.670103092784,5,0.0869486069061,2,8,0.82874015748,1,0.0179026485326,0,-2,-0.158637064697,4,0.0690459583735,tie
24,3,6,10,1.0,17,0.216379282752,5,10,1.0,8,0.111755725191,1,0,0.0,9,0.104623557561,different
29,5,2,9,0.928571428571,12,0.241557589579,2,7,0.71412924425,0,0.0,0,2,0.214442184322,12,0.241557589579,different
15,3,5,6,0.701566364386,8,0.135197381527,6,10,1.0,9,0.146613235631,-1,-4,-0.298433635614,-1,-0.0114158541042,tie
21,3,4,10,1.0,12,0.158157485637,5,10,1.0,6,0.0983836658645,-1,0,0.0,6,0.0597738197726,different
15,2,4,6,0.723577235772,5,0.0752410312207,6,9,0.940533151059,7,0.0862399801156,-2,-3,-0.216955915287,-2,-0.0109989488949,tie
24,4,6,8,0.874167283494,8,0.116613330618,4,9,0.937184115523,1,0.0131329176239,2,-1,-0.0630168320298,7,0.103480412994,tie
30,5,4,9,0.942799461642,7,0.0818807006659,5,10,1.0,4,0.0542507564794,-1,-1,-0.057200538358,3,0.0276299441865,different
24,5,3,3,0.351851851852,1,0.0183747600651,5,9,0.914876690533,0,0.0,-2,-6,-0.563024838681,1,0.0183747600651,different
27,4,3,3,0.361587982833,2,0.0400585541746,4,6,0.7,1,0.0156802507837,-1,-3,-0.338412017167,1,0.0243783033909,tie
18,3,5,9,0.913917940467,10,0.156574961046,5,8,0.881066302119,4,0.0814465916858,0,1,0.0328516383477,6,0.07512836936,tie
39,7,2,3,0.331460674157,0,0.0,4,9,0.922112802149,0,0.0,-2,-6,-0.590652127991,0,0.0,tie
27,3,3,9,0.925438596491,9,0.148951607644,4,10,1.0,3,0.0520593692022,-1,-1,-0.0745614035088,6,0.0968922384414,tie
24,4,1,5,0.561855670103,5,0.0869486069061,1,6,0.702898550725,6,0.0836363636364,0,-1,-0.141042880622,-1,0.0033122432697,tie
21,4,2,9,0.932162809258,12,0.193136472466,3,10,1.0,21,0.0815970425139,-1,-1,-0.0678371907422,-9,0.111539429952,different
27,5,5,10,1.0,20,0.234072554801,5,10,1.0,7,0.0899379762538,0,0,0.0,13,0.144134578547,tie
9,1,2,3,0.368365180467,2,0.0358132266237,4,6,0.682191780822,1,0.0166110419261,-2,-3,-0.313826600355,1,0.0192021846976,tie
13,3,4,7,0.785172704297,8,0.147668515485,2,5,0.663051897754,1,0.0140891486515,2,2,0.122120806543,7,0.133579366834,tie
12,2,4,8,0.930894308943,4,0.154891649288,4,5,0.666103127642,3,0.0919511257973,0,3,0.264791181302,1,0.062940523491,tie
12,2,3,10,1.0,12,0.191034420481,3,9,0.947450980392,6,0.0942944741533,0,1,0.0525490196078,6,0.0967399463274,tie
18,2,5,10,1.0,15,0.224835343478,4,9,0.91577928364,0,0.0,1,1,0.0842207163601,15,0.224835343478,tie
15,3,4,9,0.932054356515,13,0.211004430656,5,10,1.0,9,0.142159747767,-1,-1,-0.0679456434852,4,0.0688446828895,tie
15,2,3,7,0.770477047705,5,0.0852258088262,4,10,1.0,1,0.0150075007501,-1,-3,-0.229522952295,4,0.0702183080762,different
21,4,2,5,0.581692913386,1,0.0166023914762,1,4,0.517560073937,0,0.0,1,1,0.0641328394487,1,0.0166023914762,tie
24,4,2,6,0.694244604317,0,0.0,2,4,0.52972972973,0,0.0,0,2,0.164514874587,0,0.0,different
22,5,3,7,0.792006525285,9,0.148225862205,2,6,0.728395061728,5,0.0880230880231,1,1,0.0636114635571,4,0.0602027741818,tie
21,4,1,1,0.180064308682,0,0.0,4,6,0.6925795053,0,0.0,-3,-5,-0.512515196619,0,0.0,tie
15,2,3,8,0.844464775846,6,0.0925966865861,3,8,0.847635726795,4,0.0563540837446,0,0,-0.0031709509488,2,0.0362426028415,tie
27,5,3,10,1.0,1,0.0138603366802,5,10,1.0,1,0.0135638261813,-2,0,0.0,0,0.000296510498902,different
9,1,6,9,0.944661458333,6,0.0776046507125,5,8,0.850129198966,0,0.0,1,1,0.0945322593669,6,0.0776046507125,different
24,3,3,3,0.447539461467,1,0.0156620517547,4,5,0.598708487085,0,0.0,-1,-2,-0.151169025618,1,0.0156620517547,different
21,2,4,9,0.940014114326,7,0.0868201577761,4,7,0.779374471682,2,0.0307507876739,0,2,0.160639642644,5,0.0560693701023,different
23,5,2,4,0.477725118483,1,0.0159886537818,2,3,0.340195016251,0,0.0,0,1,0.137530102232,1,0.0159886537818,tie
18,3,3,9,0.931945556445,12,0.187992773401,3,7,0.746601941748,4,0.0792515445719,0,2,0.185343614698,8,0.108741228829,tie
21,3,3,4,0.47259565667,11,0.144479726898,5,7,0.802943581357,9,0.111781758716,-2,-3,-0.330347924687,2,0.0326979681829,tie
18,3,2,7,0.7509765625,7,0.118822969912,3,10,1.0,1,0.00236716192395,-1,-3,-0.2490234375,6,0.116455807988,different
36,6,3,5,0.644758735441,1,0.017027073836,3,10,1.0,0,0.0,0,-5,-0.355241264559,1,0.017027073836,tie
31,6,2,9,0.929693961952,12,0.185283238167,3,6,0.710241465445,6,0.0982575126788,-1,3,0.219452496507,6,0.0870257254884,tie
9,1,3,3,0.417924528302,3,0.0602160342288,4,8,0.873546511628,4,0.0865961945032,-1,-5,-0.455621983326,-1,-0.0263801602744,different
24,5,2,4,0.497041420118,0,0.0,2,4,0.520076481836,0,0.0,0,0,-0.0230350617172,0,0.0,tie
15,3,3,7,0.779411764706,0,0.0,4,8,0.861022364217,1,0.0145280278827,-1,-1,-0.0816105995114,-1,-0.0145280278827,different
21,3,3,8,0.850220264317,9,0.153441527603,4,10,1.0,14,0.134514927048,-1,-2,-0.149779735683,-5,0.0189266005544,tie
23,6,4,9,0.936424831713,8,0.131714458103,3,9,1.0,0,0.0,1,0,-0.0635751682872,8,0.131714458103,different
15,2,4,7,0.774734982332,5,0.084042126972,4,10,1.0,4,0.0636236094381,0,-3,-0.225265017668,1,0.0204185175339,tie
18,3,4,8,0.862903225806,8,0.102447835472,5,7,0.821349147517,3,0.0449518161601,-1,1,0.0415540782898,5,0.0574960193118,tie
33,6,2,9,0.913570274637,11,0.180397991724,1,8,0.836170212766,0,0.0,1,1,0.0774000618706,11,0.180397991724,different
9,2,3,6,0.699294532628,5,0.0718924358949,3,6,0.739520958084,1,0.0136145890038,0,0,-0.040226425456,4,0.0582778468911,tie
24,3,3,8,0.840674789128,7,0.11403441536,3,8,0.845470692718,3,0.0721007589214,0,0,-0.00479590358919,4,0.0419336564391,tie
21,3,1,1,0.12471395881,1,0.0192998051943,3,6,0.678966789668,4,0.0753035893995,-2,-5,-0.554252830858,-3,-0.0560037842053,different
18,3,2,8,0.879432624113,16,0.320689973371,3,8,0.87072808321,9,0.12552883966,-1,0,0.00870454090397,7,0.195161133712,different
30,5,3,10,1.0,13,0.192803992295,3,7,0.785777777778,4,0.0725591919192,0,3,0.214222222222,9,0.120244800376,different
35,7,2,5,0.585769980507,4,0.0657622991804,2,6,0.617582417582,0,0.0,0,-1,-0.0318124370756,4,0.0657622991804,tie
23,6,2,9,0.930213464696,2,0.0276979141868,2,6,0.636743215031,0,0.0,0,3,0.293470249665,2,0.0276979141868,tie
27,6,5,10,1.0,15,0.201488083832,3,9,0.916104146577,1,0.0175401069519,2,1,0.0838958534233,14,0.18394797688,tie
12,2,3,3,0.409136047666,3,0.0683431592237,4,6,0.691762621789,2,0.0322215959417,-1,-3,-0.282626574123,1,0.036121563282,different
21,3,3,5,0.543774319066,3,0.0492257677231,2,4,0.48353909465,0,0.0,1,1,0.0602352244159,3,0.0492257677231,tie
21,4,3,8,0.859027205276,10,0.160447383825,3,9,0.921692169217,2,0.0327436380002,0,-1,-0.0626649639407,8,0.127703745825,different
15,3,5,9,0.933852140078,5,0.0740355546555,5,10,1.0,0,0.0,0,-1,-0.0661478599222,5,0.0740355546555,different
21,3,4,8,0.857502095557,8,0.125178784546,3,9,0.921266968326,1,0.0164607157548,1,-1,-0.0637648727684,7,0.108718068791,tie
26,5,3,9,0.912866449511,11,0.169293317027,3,10,1.0,0,0.0,0,-1,-0.0871335504886,11,0.169293317027,tie
22,5,4,7,0.784446322908,7,0.100473875567,4,9,0.923951048951,3,0.0471900826446,0,-2,-0.139504726043,4,0.0532837929222,tie
18,2,4,5,0.63298791019,6,0.100606095627,4,5,0.642563681183,4,0.0652513632629,0,0,-0.00957577099325,2,0.0353547323641,tie
25,6,1,5,0.561855670103,5,0.0869486069061,2,4,0.450526315789,0,0.0,-1,1,0.111329354314,5,0.0869486069061,tie
30,6,3,4,0.485990338164,3,0.0523696639908,2,6,0.639751552795,0,0.0,1,-2,-0.153761214631,3,0.0523696639908,tie
30,5,4,9,0.932108626198,7,0.106525470029,6,9,0.928395061728,5,0.0798503554059,-2,0,0.00371356446969,2,0.0266751146227,tie
9,2,5,9,0.937269372694,9,0.12432132128,5,9,0.925449871465,4,0.0987987847628,0,0,0.0118195012284,5,0.0255225365173,tie
18,4,5,10,1.0,14,0.166544260052,6,10,1.0,9,0.116301312399,-1,0,0.0,5,0.0502429476531,tie
18,2,4,6,0.730372720063,8,0.129486540746,5,10,1.0,7,0.0894041495694,-1,-4,-0.269627279937,1,0.0400823911768,different
21,3,2,4,0.530818767249,7,0.128488763795,4,6,0.708703374778,4,0.0724947521395,-2,-2,-0.177884607529,3,0.0559940116557,tie
18,3,6,8,0.903560830861,12,0.238427023926,6,8,0.883534136546,9,0.158578556651,0,0,0.0200266943143,3,0.0798484672756,different
25,8,2,2,0.258977149075,2,0.0349964200622,3,8,0.829076620825,1,0.0178674763351,-1,-6,-0.57009947175,1,0.0171289437272,different
26,5,3,7,0.733716475096,6,0.0969426996539,3,9,0.912209889001,1,0.0205926061829,0,-2,-0.178493413905,5,0.076350093471,tie
21,4,4,9,0.93628185907,10,0.137911527508,3,8,0.853535353535,0,0.0,1,1,0.0827465055351,10,0.137911527508,tie
12,2,3,6,0.699559471366,8,0.123420074349,4,9,0.920980926431,1,0.0165205185369,-1,-3,-0.221421455065,7,0.106899555813,tie
27,4,3,7,0.777292576419,3,0.0441957111086,5,7,0.779374471682,1,0.0153753938369,-2,0,-0.00208189526295,2,0.0288203172717,tie
12,2,6,10,1.0,14,0.208070965413,6,9,0.929383116883,4,0.0923258559622,0,1,0.0706168831169,10,0.115745109451,tie
27,4,4,9,0.933800623053,9,0.155893525113,3,9,0.93453724605,2,0.0399534851905,1,0,-0.000736622996702,7,0.115940039923,tie
18,5,5,8,0.86410871303,11,0.171933828402,5,6,0.727272727273,1,0.0142547734397,0,2,0.136835985757,10,0.157679054962,tie
20,7,2,7,0.702777777778,6,0.0937112763321,3,6,0.673545966229,0,0.0,-1,1,0.0292318115489,6,0.0937112763321,tie
24,3,3,10,1.0,3,0.0516397209864,3,7,0.797831138652,3,0.0824223646222,0,3,0.202168861348,0,-0.0307826436358,tie
30,6,5,9,0.933176100629,10,0.147462649926,4,8,0.834914611006,1,0.0256753493186,1,1,0.0982614896232,9,0.121787300608,tie
18,3,5,9,0.909168081494,9,0.138037187344,3,10,1.0,0,0.0,2,-1,-0.0908319185059,9,0.138037187344,tie
15,3,4,9,0.930725346373,6,0.0896101653321,4,8,0.848958333333,4,0.0708585858586,0,1,0.0817670130399,2,0.0187515794735,different
12,2,4,6,0.738662567256,6,0.119969197272,5,7,0.678082191781,2,0.0294728102947,-1,-1,0.0605803754751,4,0.090496386977,different
18,3,4,10,1.0,7,0.120602338236,4,8,0.857726901063,7,0.113176243217,0,2,0.142273098937,0,0.00742609501896,different
15,2,3,7,0.780927835052,5,0.0911994276881,3,9,0.933282208589,1,0.0139486893475,0,-2,-0.152354373537,4,0.0772507383407,different
18,3,2,3,0.501675041876,1,0.0141273280903,2,2,0.303303303303,1,0.0182072982073,0,1,0.198371738573,0,-0.00407997011703,different
27,4,3,5,0.633620689655,7,0.11497404179,6,6,0.69573283859,1,0.0168729971327,-3,-1,-0.0621121489348,6,0.0981010446568,tie
18,3,3,3,0.391615541922,1,0.0172474741716,2,2,0.318315377081,1,0.0178149764046,1,1,0.073300164841,0,-0.000567502233043,tie
25,4,4,5,0.615732368897,4,0.0817474135671,4,10,1.0,4,0.038949722098,0,-5,-0.384267631103,0,0.0427976914691,tie
24,4,5,8,0.868852459016,6,0.0795777723607,5,9,0.940856560163,4,0.0539843025771,0,-1,-0.0720041011468,2,0.0255934697836,tie
30,4,4,6,0.668615984405,10,0.140057392552,4,5,0.611953612846,1,0.0162257724434,0,1,0.0566623715598,9,0.123831620109,different
27,6,3,4,0.442013129103,1,0.01845517477,2,3,0.385469223007,0,0.0,1,1,0.0565439060958,1,0.01845517477,tie
39,9,3,6,0.657603222558,4,0.0679477532317,3,6,0.692850838482,0,0.0,0,0,-0.035247615924,4,0.0679477532317,tie
15,2,3,4,0.482233502538,1,0.0207782159908,3,4,0.520220588235,0,0.0,0,0,-0.0379870856972,1,0.0207782159908,different
24,4,4,4,0.51566951567,2,0.0459211952397,4,5,0.557477110885,0,0.0,0,-1,-0.0418075952155,2,0.0459211952397,tie
25,5,5,9,0.93580060423,11,0.151606318579,4,8,0.861354581673,2,0.0165360376675,1,1,0.0744460225563,9,0.135070280912,different
28,4,5,7,0.7861003861,7,0.102988330869,5,10,1.0,1,0.0152593044539,0,-3,-0.2138996139,6,0.0877290264154,tie
23,3,4,8,0.82893685052,10,0.155708890137,3,10,1.0,1,0.0158166007905,1,-2,-0.17106314948,9,0.139892289346,different
29,5,2,4,0.511025886865,7,0.12700887845,3,5,0.625645438898,5,0.0964011891723,-1,-1,-0.114619552034,2,0.0306076892774,tie
16,3,3,9,0.92362982929,7,0.109321402686,4,10,1.0,3,0.0476903308705,-1,-1,-0.0763701707098,4,0.0616310718155,tie
30,4,5,8,0.858794384806,7,0.110689190475,4,10,1.0,4,0.0600254488901,1,-2,-0.141205615194,3,0.050663741585,tie
11,2,3,9,0.924274593064,6,0.074014001689,4,5,0.659090909091,2,0.0285095468795,-1,4,0.265183683973,4,0.0455044548096,tie
30,5,3,10,1.0,11,0.180405747737,3,10,1.0,9,0.142155924571,0,0,0.0,2,0.0382498231661,different
12,2,6,8,0.878744650499,8,0.114218137658,4,10,1.0,5,0.0679497493657,2,-2,-0.121255349501,3,0.0462683882922,different
20,5,4,9,0.932324840764,10,0.152206213151,3,10,1.0,1,0.0161250805932,1,-1,-0.0676751592357,9,0.136081132558,tie
24,4,5,10,1.0,21,0.240011537808,5,10,1.0,13,0.17458923685,0,0,0.0,8,0.0654223009578,tie
36,6,2,4,0.475847893114,0,0.0,5,6,0.7,1,0.0156802507837,-3,-2,-0.224152106886,-1,-0.0156802507837,different
30,5,5,10,1.0,17,0.240183337106,3,10,1.0,2,0.0288720393965,2,0,0.0,15,0.21131129771,tie
24,5,3,8,0.843893480257,8,0.136720363486,5,10,1.0,2,0.0281129689476,-2,-2,-0.156106519743,6,0.108607394539,tie
27,5,2,6,0.668498168498,4,0.0617876547245,1,7,0.800331400166,0,0.0,1,-1,-0.131833231668,4,0.0617876547245,tie
21,3,1,1,0.155579399142,0,0.0,3,3,0.531538461538,1,0.0139916083916,-2,-2,-0.375959062397,-1,-0.0139916083916,tie
27,5,3,7,0.752457551385,3,0.0452225998385,4,10,1.0,0,0.0,-1,-3,-0.247542448615,3,0.0452225998385,tie
12,2,3,9,0.931229773463,10,0.162675497167,4,9,0.916746411483,1,0.0174058286211,-1,0,0.0144833619795,9,0.145269668546,tie
27,3,3,8,0.847396768402,6,0.090851147611,3,9,0.925577416595,1,0.0155595302901,0,-1,-0.0781806481932,5,0.0752916173209,tie
12,2,3,8,0.863672814755,1,0.0252501915378,3,9,0.920909090909,1,0.0165355371901,0,-1,-0.0572362761537,0,0.00871465434767,different
15,3,5,8,0.852686308492,9,0.147043095617,5,8,0.861022364217,2,0.0346703456288,0,0,-0.00833605572505,7,0.112372749988,different
16,3,3,5,0.564994882293,0,0.0,7,9,0.936865021771,5,0.0728539385143,-4,-4,-0.371870139478,-5,-0.0728539385143,tie
18,2,6,8,0.862348178138,4,0.0764369459537,2,3,0.469512195122,1,0.0158441558442,4,5,0.392835983016,3,0.0605927901095,tie
18,3,7,10,1.0,7,0.0951759029026,5,9,0.931978107897,1,0.0142213376928,2,1,0.0680218921032,6,0.0809545652098,tie
17,4,3,3,0.427333974976,5,0.0950281046617,4,4,0.576642335766,1,0.0147518985475,-1,-1,-0.14930836079,4,0.0802762061142,different
33,6,2,4,0.507204610951,1,0.0162036789047,3,5,0.616740088106,0,0.0,-1,-1,-0.109535477155,1,0.0162036789047,tie
27,5,2,8,0.836223506744,7,0.113753572426,5,8,0.845195729537,1,0.0161824652216,-3,0,-0.00897222279363,6,0.0975711072046,tie
21,4,4,9,0.925241864556,6,0.0921782686454,5,9,0.930566640064,6,0.0888688964667,-1,0,-0.005324775508,0,0.00330937217873,tie
9,2,4,6,0.715956558062,3,0.050918808794,3,9,1.0,4,0.0601150895141,1,-3,-0.284043441938,-1,-0.00919628072009,tie
9,2,5,10,1.0,17,0.210437362986,5,10,1.0,7,0.090869457518,0,0,0.0,10,0.119567905468,different
26,6,2,7,0.778837814397,10,0.168143875521,2,7,0.760989010989,4,0.0747519147519,0,0,0.0178488034082,6,0.0933919607692,tie
17,3,3,8,0.850823937554,11,0.176531563047,5,7,0.788781770377,2,0.0318827185085,-2,1,0.0620421671773,9,0.144648844539,tie
18,2,3,9,0.932486100079,9,0.178725075368,3,3,0.513966480447,2,0.100071102082,0,6,0.418519619633,7,0.0786539732859,tie
15,3,5,6,0.752054794521,13,0.229501705963,6,9,0.937047756874,10,0.144379686883,-1,-3,-0.184992962354,3,0.0851220190799,tie
23,6,3,4,0.491017964072,3,0.0505030830532,2,4,0.4375,0,0.0,1,0,0.0535179640719,3,0.0505030830532,tie
18,4,2,3,0.429759704251,1,0.0155896762845,4,10,1.0,1,0.0126488810216,-2,-7,-0.570240295749,0,0.00294079526283,tie
19,3,5,10,1.0,4,0.0508803936282,6,9,1.0,0,0.0,-1,1,0.0,4,0.0508803936282,different
12,2,5,10,1.0,7,0.0963066710881,7,10,1.0,6,0.0913735485698,-2,0,0.0,1,0.00493312251826,tie
25,5,3,8,0.842446709917,7,0.109431147524,5,8,0.828300258844,1,0.0141501294219,-2,0,0.0141464510728,6,0.0952810181021,different
20,5,2,5,0.560276679842,5,0.0868959107807,3,6,0.767598842816,0,0.0,-1,-1,-0.207322162974,5,0.0868959107807,different
12,2,6,9,0.954423592493,11,0.113899159831,5,8,0.899363794101,25,0.0679110363321,1,1,0.0550597983927,-14,0.0459881234993,tie
16,3,4,9,0.93536121673,22,0.296103014969,4,10,1.0,6,0.0983349761165,0,-1,-0.06463878327,16,0.197768038852,tie
9,1,5,10,1.0,4,0.0644924065066,4,8,0.854149203688,2,0.0720871751886,1,2,0.145850796312,2,-0.00759476868201,tie
12,2,2,9,0.925044091711,6,0.089248834602,4,7,0.77519379845,1,0.0156667449691,-2,2,0.149850293261,5,0.0735820896329,tie
20,4,3,6,0.69696969697,6,0.0830848392077,4,7,0.734756097561,1,0.0276792313378,-1,-1,-0.0377864005913,5,0.05540560787,different
24,5,3,8,0.846014492754,7,0.110212609773,3,9,0.920692798541,5,0.090991961548,0,-1,-0.0746783057879,2,0.0192206482252,tie
36,5,3,9,0.928989139515,10,0.167975701335,4,9,0.921124206709,1,0.0164905629276,-1,0,0.00786493280648,9,0.151485138408,tie
27,4,2,8,0.838556505223,7,0.112133151167,2,6,0.636743215031,0,0.0,0,2,0.201813290192,7,0.112133151167,different
9,2,3,6,0.699472759227,3,0.0444675652191,3,5,0.628205128205,2,0.0286993006993,0,1,0.0712676310216,1,0.0157682645198,tie
12,2,5,8,0.852307692308,9,0.135809265084,5,10,1.0,5,0.0741040696497,0,-2,-0.147692307692,4,0.0617051954346,tie
30,5,2,7,0.758064516129,1,0.0160038232825,3,7,0.778813559322,2,0.0728813559322,-1,0,-0.020749043193,-1,-0.0568775326497,tie
21,3,5,10,1.0,10,0.138556949913,4,9,0.933231005372,6,0.0348398799972,1,1,0.0667689946278,4,0.103717069916,tie
25,7,5,8,0.872372372372,10,0.149262645545,4,10,1.0,7,0.0874928098037,1,-2,-0.127627627628,3,0.0617698357415,different
18,3,4,8,0.929693961952,5,0.139010088524,5,5,0.671577655003,3,0.0856788883308,-1,3,0.258116306949,2,0.0533312001936,different
9,2,6,10,1.0,18,0.227957557167,5,10,1.0,19,0.192237597302,1,0,0.0,-1,0.0357199598654,different
12,2,5,5,0.586575875486,4,0.068335671821,4,6,0.672007540057,1,0.00769257133065,1,-1,-0.0854316645702,3,0.0606431004903,tie
36,5,1,3,0.34830230011,0,0.0,4,4,0.52972972973,1,0.0163865683866,-3,-1,-0.18142742962,-1,-0.0163865683866,tie
18,2,4,6,0.735202492212,5,0.0921348249545,4,8,0.900074571216,2,0.0293729238696,0,-2,-0.164872079004,3,0.062761901085,tie
15,2,3,7,0.768181818182,7,0.110138560324,3,4,0.548442906574,1,0.0157345077068,0,3,0.219738911607,6,0.0944040526176,tie
18,3,3,5,0.57051961824,3,0.0646339492327,4,4,0.55,2,0.0749905956113,-1,1,0.0205196182397,1,-0.0103566463786,tie
27,5,2,6,0.6872125115,8,0.140696230887,4,8,0.831884057971,0,0.0,-2,-2,-0.144671546471,8,0.140696230887,tie
14,3,2,5,0.545454545455,4,0.07132359298,4,9,0.934378060725,1,0.0178149764046,-2,-4,-0.38892351527,3,0.0535086165754,tie
18,3,2,3,0.337416481069,2,0.0375679949661,2,7,0.772251308901,6,0.0848056481041,0,-4,-0.434834827831,-4,-0.047237653138,different
24,5,3,6,0.686057248384,5,0.0811991336196,5,10,1.0,5,0.0804336678632,-2,-4,-0.313942751616,0,0.000765465756449,tie
15,2,2,5,0.592911877395,4,0.0646284664359,3,3,0.381951731375,1,0.0190861394639,-1,2,0.21096014602,3,0.045542326972,different
21,4,7,9,0.928451178451,5,0.136013167612,5,7,0.840924092409,3,0.0881524152415,2,2,0.0875270860419,2,0.0478607523702,tie
9,2,2,4,0.51586582049,5,0.0895142345816,3,6,0.753191489362,2,0.0258001289491,-1,-2,-0.237325668872,3,0.0637141056325,tie
18,3,2,6,0.687392055268,1,0.0145665196371,2,8,0.848167539267,1,0.015871807076,0,-2,-0.160775483999,0,-0.00130528743888,tie
36,6,2,3,0.397578203835,1,0.0170212207263,2,4,0.464818763326,0,0.0,0,-1,-0.0672405594917,1,0.0170212207263,tie
24,5,6,8,0.88033589923,17,0.221246822979,5,7,0.768935762224,1,0.0174392050902,1,1,0.111400137006,16,0.203807617889,tie
16,3,5,6,0.673704414587,3,0.0485643850473,3,5,0.716842961758,0,0.0,2,1,-0.0431385471702,3,0.0485643850473,tie
15,2,5,10,1.0,8,0.123928381762,6,10,1.0,13,0.162141199226,-1,0,0.0,-5,-0.0382128174647,tie
30,6,3,5,0.621886120996,1,0.0150071438966,3,7,0.778249787596,0,0.0,0,-2,-0.156363666599,1,0.0150071438966,different
19,4,3,7,0.780739466896,10,0.161283311011,5,10,1.0,1,0.0172408444636,-2,-3,-0.219260533104,9,0.144042466548,tie
12,2,5,5,0.649375600384,2,0.0358641426424,4,5,0.746632456703,4,0.101058953875,1,0,-0.0972568563188,-2,-0.0651948112325,tie
27,5,4,8,0.854202401372,12,0.188511863391,2,9,0.909657320872,0,0.0,2,-1,-0.0554549195001,12,0.188511863391,different
30,5,2,3,0.386597938144,0,0.0,3,5,0.582933844679,0,0.0,-1,-2,-0.196335906534,0,0.0,tie
19,4,6,10,1.0,11,0.160528461464,4,10,1.0,7,0.108878890601,2,0,0.0,4,0.0516495708631,tie
18,3,5,10,1.0,19,0.238823656824,6,10,1.0,6,0.0706058526237,-1,0,0.0,13,0.1682178042,tie
18,5,3,3,0.464006938422,0,0.0,4,4,0.626074498567,1,0.0130294347486,-1,-1,-0.162067560146,-1,-0.0130294347486,tie
19,5,3,6,0.724025974026,5,0.080871614445,4,8,0.85077186964,1,0.0155995633869,-1,-2,-0.126745895614,4,0.0652720510582,different
18,4,4,8,0.871987951807,15,0.216497962109,4,9,0.938559322034,5,0.0704930662558,0,-1,-0.0665713702267,10,0.146004895853,different
17,5,4,5,0.590163934426,1,0.0162661810413,5,8,0.861244019139,1,0.0145048571843,-1,-3,-0.271080084713,0,0.00176132385697,tie
12,2,5,10,1.0,20,0.316086255905,3,8,0.879917184265,9,0.0522316331012,2,2,0.120082815735,11,0.263854622804,different
21,4,5,8,0.882026370576,14,0.168421351344,4,8,0.899515738499,2,0.0234426590359,1,0,-0.0174893679228,12,0.144978692308,different
18,3,3,8,0.872468117029,6,0.0867233537009,4,10,1.0,8,0.0992565708599,-1,-2,-0.127531882971,-2,-0.012533217159,tie
24,4,2,9,0.930098684211,11,0.18366177118,2,9,0.921692169217,6,0.108213730464,0,0,0.0084065149936,5,0.0754480407159,tie
27,6,4,10,1.0,15,0.211301169432,5,10,1.0,10,0.141988878831,-1,0,0.0,5,0.0693122906012,different
27,5,1,1,0.177419354839,0,0.0,3,10,1.0,0,0.0,-2,-9,-0.822580645161,0,0.0,tie
20,5,3,8,0.844606946984,6,0.0925120461048,2,6,0.659491193738,0,0.0,1,2,0.185115753246,6,0.0925120461048,different
28,6,3,8,0.85593220339,7,0.100064583202,3,10,1.0,6,0.0904848010251,0,-2,-0.14406779661,1,0.00957978217694,different
8,2,3,6,0.668932038835,5,0.0818836395135,3,8,0.832692307692,0,0.0,0,-2,-0.163760268857,5,0.0818836395135,tie
33,5,2,7,0.73602484472,4,0.0698469140363,3,5,0.521452145215,0,0.0,-1,2,0.214572699506,4,0.0698469140363,tie
30,3,3,4,0.503407984421,3,0.0527776068457,4,7,0.783402489627,1,0.0150946812524,-1,-3,-0.279994505206,2,0.0376829255933,tie
24,4,2,5,0.60989010989,8,0.13675667579,3,3,0.349171270718,0,0.0,-1,2,0.260718839172,8,0.13675667579,tie
18,2,4,9,0.933228593873,7,0.0992007288932,5,8,0.883534136546,5,0.0853717901911,-1,1,0.0496944573266,2,0.0138289387021,different
9,2,6,9,0.948359659781,14,0.212409716921,6,8,0.920146856356,13,0.174732362635,0,1,0.0282128034252,1,0.037677354286,tie
21,4,3,3,0.39099283521,0,0.0,3,5,0.606334841629,0,0.0,0,-2,-0.215342006419,0,0.0,tie
18,2,3,3,0.424007744434,0,0.0,4,6,0.726199842644,3,0.0373378156069,-1,-3,-0.30219209821,-3,-0.0373378156069,tie
37,7,2,9,0.918791312559,8,0.127426098129,2,7,0.741328047572,1,0.0180268492657,0,2,0.177463264987,7,0.109399248863,tie
15,3,3,10,1.0,12,0.188199433712,5,10,1.0,5,0.0746025275173,-2,0,0.0,7,0.113596906194,tie
14,4,4,9,0.928810720268,10,0.16300056665,3,10,1.0,4,0.0918707506834,1,-1,-0.071189279732,6,0.0711298159665,different
21,3,3,3,0.499579478553,2,0.0313999768635,3,8,0.865030674847,0,0.0,0,-5,-0.365451196293,2,0.0313999768635,different
17,5,4,8,0.839195979899,5,0.0898498066541,5,9,0.92719665272,1,0.0152209965766,-1,-1,-0.0880006728202,4,0.0746288100774,tie
25,4,3,9,0.940056417489,12,0.149147183582,4,7,0.817482517483,6,0.0925874125874,-1,2,0.122573900007,6,0.0565597709949,tie
21,4,2,6,0.650565262076,0,0.0,2,5,0.618215271389,0,0.0,0,1,0.0323499906869,0,0.0,tie
12,2,5,7,0.797136038186,9,0.143854637081,3,5,0.581730769231,0,0.0,2,2,0.215405268955,9,0.143854637081,tie
21,3,4,7,0.792006525285,11,0.226612673366,5,10,1.0,11,0.177082335141,-1,-3,-0.207993474715,0,0.0495303382252,tie
12,2,4,5,0.577105014191,6,0.125215856056,5,6,0.71334431631,4,0.0981518646099,-1,-1,-0.136239302119,2,0.0270639914462,different
33,6,2,2,0.304170905392,1,0.0171597454118,3,7,0.736629667003,0,0.0,-1,-5,-0.432458761611,1,0.0171597454118,tie
24,4,2,5,0.557425742574,4,0.0668040781773,2,6,0.673956262425,1,0.0180806072655,0,-1,-0.116530519851,3,0.0487234709118,tie
15,2,3,9,0.945337620579,6,0.0772349657538,5,10,1.0,6,0.0916676391644,-2,-1,-0.0546623794212,0,-0.0144326734106,different
15,2,4,8,0.858215179316,8,0.131323810734,5,8,0.871681415929,1,0.0134137838563,-1,0,-0.0134662366131,7,0.117910026878,tie
24,2,3,9,0.934615384615,1,0.024220760652,4,7,0.78728606357,3,0.0399081277321,-1,2,0.147329321046,-2,-0.0156873670801,tie
27,4,2,8,0.857621440536,1,0.0141273280903,5,7,0.791533546326,3,0.037904443799,-3,1,0.0660878942101,-2,-0.0237771157087,tie
30,6,3,5,0.623102866779,10,0.139742159143,4,6,0.708298407376,1,0.0152465137545,-1,-1,-0.0851955405973,9,0.124495645388,different
25,4,3,6,0.724473257699,10,0.141050050309,2,8,0.931007137193,0,0.0,1,-2,-0.206533879494,10,0.141050050309,tie
27,5,4,10,1.0,11,0.160545169812,5,8,0.86320754717,5,0.0784734133791,-1,2,0.13679245283,6,0.082071756433,tie
30,6,3,10,1.0,12,0.191938704567,2,8,0.838888888889,1,0.0168417508418,1,2,0.161111111111,11,0.175096953726,tie
30,6,1,2,0.252747252747,0,0.0,2,6,0.65690376569,0,0.0,-1,-4,-0.404156512943,0,0.0,different
21,4,5,10,1.0,9,0.101119485895,6,9,0.938210227273,7,0.0963171487603,-1,1,0.0617897727273,2,0.004802337135,different
27,4,2,6,0.661354581673,4,0.0672033057362,2,5,0.573947110676,0,0.0,0,1,0.0874074709975,4,0.0672033057362,different
15,2,3,6,0.722675367047,6,0.110252157407,5,9,0.932766615147,5,0.0771392440635,-2,-3,-0.2100912481,1,0.0331129133438,tie
30,4,3,4,0.518413597734,6,0.0957801952463,3,6,0.632286995516,0,0.0,0,-2,-0.113873397782,6,0.0957801952463,different
30,5,2,7,0.79809976247,7,0.111652200019,3,8,0.866666666667,4,0.0606339254615,-1,-1,-0.0685669041964,3,0.0510182745579,tie
26,8,3,6,0.702547247329,14,0.198206632801,2,8,0.823529411765,0,0.0,1,-2,-0.120982164435,14,0.198206632801,tie
24,5,4,7,0.763888888889,5,0.0824659231722,4,9,0.926829268293,1,0.0152978056426,0,-2,-0.162940379404,4,0.0671681175296,tie
30,8,1,2,0.256673511294,0,0.0,3,4,0.627674750357,1,0.0129736739722,-2,-2,-0.371001239063,-1,-0.0129736739722,tie
30,6,1,2,0.252747252747,0,0.0,2,2,0.317171717172,0,0.0,-1,0,-0.0644244644245,0,0.0,tie
24,5,2,5,0.545842217484,4,0.0719318965449,4,6,0.680733944954,0,0.0,-2,-1,-0.13489172747,4,0.0719318965449,tie
24,5,2,6,0.698581560284,9,0.148143570882,1,3,0.307167235495,0,0.0,1,3,0.391414324789,9,0.148143570882,tie
20,3,3,5,0.658380112269,7,0.106952597014,4,10,1.0,0,0.0,-1,-5,-0.341619887731,7,0.106952597014,tie
12,2,3,4,0.441176470588,0,0.0,4,5,0.695164681149,1,0.0127463846595,-1,-1,-0.253988210561,-1,-0.0127463846595,tie
26,6,5,8,0.865930599369,9,0.148295767711,3,8,0.840909090909,0,0.0,2,0,0.02502150846,9,0.148295767711,tie
37,8,6,9,0.946134347275,16,0.174283008467,5,10,1.0,11,0.156964560863,1,-1,-0.053865652725,5,0.0173184476039,tie
21,6,2,5,0.543010752688,0,0.0,1,3,0.435588507878,0,0.0,1,2,0.107422244811,0,0.0,tie
24,4,4,4,0.571308724832,3,0.148039282952,5,7,0.816584680253,1,0.012782214272,-1,-3,-0.245275955421,2,0.13525706868,tie
30,5,4,8,0.837786259542,3,0.0482863446749,4,9,0.925577416595,1,0.0155595302901,0,-1,-0.0877911570534,2,0.0327268143849,different
27,5,3,10,1.0,7,0.120806058402,4,10,1.0,1,0.0153624078624,-1,0,0.0,6,0.10544365054,different
29,7,3,6,0.67680608365,5,0.0814539839145,5,9,0.926155969634,1,0.0125528577702,-2,-3,-0.249349885984,4,0.0689011261443,tie
30,7,1,4,0.474226804124,0,0.0,1,3,0.50487804878,0,0.0,0,1,-0.0306512446568,0,0.0,tie
24,5,2,4,0.507722007722,0,0.0,5,5,0.652278177458,1,0.0145396410145,-3,-1,-0.144556169736,-1,-0.0145396410145,different
18,3,4,4,0.487969201155,1,0.0162348698169,4,5,0.600550964187,1,0.0167025628183,0,-1,-0.112581763032,0,-0.000467693001348,tie
22,5,5,9,0.931962025316,10,0.16269234389,4,8,0.822990844354,0,0.0,1,1,0.108971180962,10,0.16269234389,tie
18,4,3,8,0.86076986077,9,0.133175926856,3,8,0.83738317757,3,0.050997451147,0,0,0.0233866831998,6,0.0821784757092,different
33,4,4,10,1.0,18,0.299451107658,4,9,0.932766615147,9,0.211504847548,0,1,0.0672333848532,9,0.0879462601098,different
12,1,4,4,0.538461538462,2,0.0317515853925,3,7,0.770851624232,1,0.0159693511054,1,-3,-0.23239008577,1,0.0157822342871,tie
33,5,2,5,0.566326530612,2,0.0344245504893,1,4,0.43595505618,0,0.0,1,1,0.130371474432,2,0.0344245504893,different
30,4,3,4,0.510536398467,1,0.0301599510034,3,4,0.586698337292,1,0.00194342474628,0,0,-0.0761619388247,0,0.0282165262572,different
27,5,5,9,0.927163667524,10,0.168405946681,2,3,0.42492917847,0,0.0,3,6,0.502234489053,10,0.168405946681,tie
30,6,1,5,0.561855670103,5,0.0869486069061,4,7,0.741328047572,0,0.0,-3,-2,-0.179472377469,5,0.0869486069061,tie
24,5,2,8,0.884848484848,16,0.272614622057,3,6,0.637877211238,4,0.0640544886955,-1,2,0.24697127361,12,0.208560133362,different
12,2,1,1,0.177419354839,0,0.0,5,7,0.783940397351,1,0.0150571944612,-4,-6,-0.606521042512,-1,-0.0150571944612,tie
12,2,3,9,0.93536121673,4,0.0622556433488,4,7,0.79609375,5,0.0779829545455,-1,2,0.13926746673,-1,-0.0157273111966,tie
9,1,4,5,0.671081677704,3,0.0325176231156,4,10,1.0,9,0.133616686344,0,-5,-0.328918322296,-6,-0.101099063228,tie
12,2,6,10,1.0,14,0.151576760299,5,9,0.952224052718,8,0.136921771255,1,1,0.0477759472817,6,0.0146549890443,different
24,4,2,7,0.74216380182,6,0.102333850797,1,8,0.805369127517,0,0.0,1,-1,-0.0632053256968,6,0.102333850797,different
17,3,4,9,0.92547660312,11,0.174039867795,4,8,0.824596774194,1,0.0183357771261,0,1,0.100879828926,10,0.155704090668,different
27,5,2,6,0.66137040715,5,0.0837538715977,3,4,0.508011310085,3,0.0924599434496,-1,2,0.153359097065,2,-0.00870607185188,tie
18,3,1,9,0.92928452579,10,0.17027073836,3,9,0.93023255814,5,0.0800466574324,-2,0,-0.000948032349186,5,0.0902240809281,different
12,2,2,4,0.55497382199,2,0.059072448536,3,8,0.883299798793,1,0.00164624108286,-1,-4,-0.328325976803,1,0.0574262074532,different
15,3,1,10,1.0,13,0.203413651194,3,9,1.0,0,0.0,-2,1,0.0,13,0.203413651194,different
21,5,4,9,0.942645074224,12,0.171487841709,4,10,1.0,10,0.12418537058,0,-1,-0.057354925776,2,0.0473024711292,tie
12,2,5,8,0.874446085672,7,0.0861237253793,4,9,0.935887988209,6,0.0707067729617,1,-1,-0.0614419025372,1,0.0154169524176,different
21,3,3,7,0.774336283186,9,0.147085238675,3,10,1.0,2,0.0337380801017,0,-3,-0.225663716814,7,0.113347158573,tie
39,6,2,8,0.839924670433,8,0.13045456773,2,9,0.89776733255,0,0.0,0,-1,-0.0578426621168,8,0.13045456773,tie
21,3,2,4,0.500978473581,3,0.0495147644025,2,7,0.779374471682,0,0.0,0,-3,-0.278395998101,3,0.0495147644025,different
9,2,4,4,0.494047619048,2,0.0334683129757,3,6,0.741648106904,4,0.0461375447122,1,-2,-0.247600487857,-2,-0.0126692317364,tie
30,5,2,2,0.23937360179,1,0.0188680422145,2,5,0.5203969129,0,0.0,0,-3,-0.28102331111,1,0.0188680422145,different
18,3,2,5,0.659090909091,4,0.0628528156409,3,5,0.660947712418,2,0.0297207367796,-1,0,-0.00185680332739,2,0.0331320788614,different
30,4,4,10,1.0,11,0.134162997619,4,9,0.924281984334,0,0.0,0,1,0.0757180156658,11,0.134162997619,tie
30,5,4,10,1.0,8,0.0951369395342,5,9,0.945760598504,13,0.178097936976,-1,1,0.0542394014963,-5,-0.0829609974416,tie
24,4,3,5,0.619856887299,11,0.211220913607,3,6,0.664488017429,0,0.0,0,-1,-0.0446311301304,11,0.211220913607,different
18,3,6,9,0.950437317784,6,0.101121744502,4,8,0.890566037736,2,0.0621573698544,2,1,0.0598712800484,4,0.0389643746479,tie
22,4,3,5,0.619002822201,6,0.108750922374,3,5,0.612834978843,9,0.130601359149,0,0,0.00616784335788,-3,-0.0218504367749,different
21,4,2,9,0.918017159199,7,0.112560732296,4,8,0.846560846561,3,0.0328170594837,-2,1,0.0714563126384,4,0.0797436728122,tie
30,4,5,10,1.0,14,0.195790010001,5,8,0.854515050167,4,0.0663970811797,0,2,0.145484949833,10,0.129392928822,tie
15,2,3,5,0.597549481621,4,0.0635929490661,4,6,0.700182815356,1,0.014066810703,-1,-1,-0.102633333735,3,0.0495261383631,different
9,2,4,6,0.78141025641,12,0.0605090077209,3,5,0.646915584416,2,0.0313282172373,1,1,0.134494671995,10,0.0291807904836,tie
21,3,3,6,0.73886328725,5,0.0590626945106,3,10,1.0,7,0.0303092236231,0,-4,-0.26113671275,-2,0.0287534708875,different
12,2,3,6,0.737692307692,2,0.0259508149843,3,3,0.498723404255,1,0.0154800773694,0,3,0.238968903437,1,0.0104707376148,tie
19,4,4,5,0.560037523452,3,0.04747100302,3,9,0.931978107897,4,0.10719169806,1,-4,-0.371940584445,-1,-0.0597206950396,different
22,4,2,3,0.391437308869,2,0.0343894592044,3,5,0.556574923547,1,0.0185413770735,-1,-2,-0.165137614679,1,0.015848082131,tie
12,2,3,10,1.0,13,0.1392724376,6,10,1.0,2,0.0254380165289,-3,0,0.0,11,0.113834421071,different
18,3,3,3,0.514285714286,1,0.0137698201957,3,6,0.805223880597,2,0.0271478968792,0,-3,-0.290938166311,-1,-0.0133780766835,different
40,7,3,3,0.389117043121,1,0.0173183056877,2,5,0.563758389262,1,0.0174392050902,1,-2,-0.174641346141,0,-0.000120899402556,different
14,3,4,6,0.755980861244,7,0.126765799257,3,5,0.629080118694,1,0.0179911878428,1,1,0.12690074255,6,0.108774611414,tie
30,5,2,3,0.351851851852,2,0.0367495201302,2,3,0.355555555556,0,0.0,0,0,-0.0037037037037,2,0.0367495201302,different
21,4,3,10,1.0,20,0.254653132417,5,10,1.0,5,0.0886640072783,-2,0,0.0,15,0.165989125139,different
30,5,2,6,0.658291457286,0,0.0,3,8,0.847100175747,0,0.0,-1,-2,-0.18880871846,0,0.0,tie
22,4,1,9,0.919400187441,9,0.142279538574,1,2,0.18691588785,0,0.0,0,7,0.732484299591,9,0.142279538574,tie
29,6,2,5,0.525554484089,4,0.065064724165,2,7,0.756756756757,0,0.0,0,-2,-0.231202272668,4,0.065064724165,tie
27,5,2,5,0.57518115942,4,0.0611160497818,2,10,1.0,0,0.0,0,-5,-0.42481884058,4,0.0611160497818,different
18,4,0,0,0.0,0,0.0,0,0,0.0,0,0.0,0,0,0.0,0,0.0,tie
24,5,4,6,0.690909090909,7,0.12124535316,5,9,0.925193465176,0,0.0,-1,-3,-0.234284374267,7,0.12124535316,different
27,4,3,6,0.652488687783,8,0.135961916937,4,9,0.933739527799,1,0.0138530776155,-1,-3,-0.281250840016,7,0.122108839322,different
19,2,3,7,0.769092542677,6,0.0941659402065,5,9,0.938254080908,5,0.0708432802116,-2,-2,-0.169161538231,1,0.0233226599949,different
24,4,2,6,0.686905632772,4,0.0493578046519,2,7,0.774805867127,0,0.0,0,-1,-0.0879002343543,4,0.0493578046519,tie
31,6,2,4,0.4859437751,1,0.0169357728311,2,5,0.555669050051,0,0.0,0,-1,-0.0697252749507,1,0.0169357728311,tie
9,2,5,10,1.0,10,0.138612162196,5,10,1.0,1,0.0158995549905,0,0,0.0,9,0.122712607205,tie
18,4,6,10,1.0,17,0.176692818209,5,10,1.0,4,0.0530821584832,1,0,0.0,13,0.123610659726,tie
15,2,5,9,0.939501779359,12,0.145228803133,6,10,1.0,11,0.129270341752,-1,-1,-0.0604982206406,1,0.0159584613809,tie
12,2,6,10,1.0,6,0.0932443874109,5,8,0.896445131376,4,0.0920837431502,1,2,0.103554868624,2,0.00116064426066,different
13,2,2,4,0.441401971522,0,0.0,4,5,0.650602409639,1,0.0146097115736,-2,-1,-0.209200438116,-1,-0.0146097115736,tie
9,1,6,9,0.947073474471,14,0.153393177073,4,10,1.0,4,0.0408402849662,2,-1,-0.0529265255293,10,0.112552892107,different
24,2,4,4,0.506292352372,3,0.053777390716,5,6,0.716381418093,1,0.0148240349707,-1,-2,-0.210089065721,2,0.0389533557453,tie
12,2,4,10,1.0,16,0.176196294204,5,9,0.957930367505,18,0.170632143485,-1,1,0.0420696324952,-2,0.00556415071848,different
24,7,3,4,0.521582733813,8,0.185113061967,3,7,0.730726256983,0,0.0,0,-3,-0.20914352317,8,0.185113061967,different
24,6,5,8,0.869531849578,5,0.0850953048013,2,8,0.865067466267,2,0.04023988006,3,0,0.00446438331103,3,0.0448554247414,tie
18,3,2,2,0.287211740042,1,0.0176813728928,2,3,0.411594202899,0,0.0,0,-1,-0.124382462857,1,0.0176813728928,different
12,2,4,10,1.0,8,0.104825481319,4,9,0.947533281128,7,0.102138534918,0,1,0.0524667188724,1,0.00268694640013,tie
27,5,1,4,0.46088794926,4,0.07132359298,3,7,0.773240660295,0,0.0,-2,-3,-0.312352711035,4,0.07132359298,different
33,6,5,10,1.0,9,0.129139063335,5,9,0.931116389549,5,0.0790326063485,0,1,0.0688836104513,4,0.0501064569864,different
21,2,4,7,0.799843014129,5,0.0842077465816,2,8,0.941991341991,0,0.0,2,-1,-0.142148327863,5,0.0842077465816,tie
21,3,5,7,0.818116975749,7,0.130298458389,5,8,0.926108374384,2,0.0317957904165,0,-1,-0.107991398635,5,0.0985026679728,different
15,3,5,9,0.942009440324,11,0.143729303858,5,10,1.0,7,0.0716080964639,0,-1,-0.0579905596763,4,0.0721212073937,different
29,5,4,6,0.68513388735,2,0.0311505627697,2,7,0.751191611058,0,0.0,2,-1,-0.0660577237082,2,0.0311505627697,tie
27,3,2,2,0.229418221734,1,0.0185159492204,3,9,0.919069767442,0,0.0,-1,-7,-0.689651545708,1,0.0185159492204,different
15,3,3,8,0.867029548989,11,0.157225077616,5,9,0.944015444015,9,0.115334035334,-2,-1,-0.0769858950263,2,0.0418910422819,tie
18,3,2,2,0.285714285714,0,0.0,4,6,0.69527145359,1,0.0159274000955,-2,-4,-0.409557167876,-1,-0.0159274000955,different
15,3,3,5,0.598298676749,1,0.0159433173344,5,10,1.0,1,0.0146923189896,-2,-5,-0.401701323251,0,0.00125099834481,different
12,3,2,5,0.58640776699,4,0.0655069116108,4,7,0.756302521008,0,0.0,-2,-2,-0.169894754018,4,0.0655069116108,tie
20,5,2,8,0.837476099426,8,0.129009787685,2,7,0.67496886675,0,0.0,0,1,0.162507232677,8,0.129009787685,tie
21,4,3,5,0.611872146119,6,0.112126767497,2,7,0.736612021858,0,0.0,1,-2,-0.124739875739,6,0.112126767497,tie
24,4,3,7,0.810830860534,1,0.020188245287,4,6,0.710482529118,2,0.0509060656482,-1,1,0.100348331416,-1,-0.0307178203612,tie
21,4,5,10,1.0,18,0.247322518703,5,10,1.0,1,0.0157345077068,0,0,0.0,17,0.231588010997,tie
30,2,4,9,0.91273100616,4,0.0692732227506,5,9,0.928217821782,3,0.0909150915092,-1,0,-0.015486815622,1,-0.0216418687585,tie
18,3,6,9,0.929925803792,4,0.121679022486,4,8,0.867175572519,3,0.107698820264,2,1,0.0627502312732,1,0.0139802022219,tie
21,4,4,5,0.648860958366,8,0.123758530766,4,9,0.926208651399,1,0.015427558023,0,-4,-0.277347693033,7,0.108330972743,different
12,3,3,4,0.517045454545,3,0.0617642503098,3,8,0.854879065888,0,0.0,0,-4,-0.337833611343,3,0.0617642503098,different
15,3,6,8,0.860088365243,11,0.164708925766,5,7,0.785185185185,3,0.0549524878414,1,1,0.0749031800578,8,0.109756437924,tie
21,3,3,4,0.491542288557,2,0.0335682183876,2,4,0.461855670103,0,0.0,1,0,0.0296866184541,2,0.0335682183876,tie
15,3,4,9,0.934312210201,10,0.147736478916,5,8,0.835849056604,1,0.0171595197256,-1,1,0.0984631535972,9,0.130576959191,different
9,1,4,10,1.0,13,0.196560289342,3,6,0.611607142857,0,0.0,1,4,0.388392857143,13,0.196560289342,different
18,3,4,10,1.0,18,0.193873020222,6,10,1.0,11,0.133307783351,-2,0,0.0,7,0.0605652368705,tie
18,3,5,8,0.866666666667,8,0.11881501974,4,9,0.942574257426,6,0.0682316231623,1,-1,-0.0759075907591,2,0.0505833965777,tie
33,5,3,5,0.580867850099,1,0.0166351378104,2,7,0.750716332378,0,0.0,1,-2,-0.16984848228,1,0.0166351378104,tie
12,2,3,6,0.702015775635,5,0.071451378006,4,9,1.0,1,0.00692126746921,-1,-3,-0.297984224365,4,0.0645301105368,tie
27,5,3,5,0.571703561116,2,0.0324697396338,3,7,0.745365853659,0,0.0,0,-2,-0.173662292542,2,0.0324697396338,different
27,5,2,7,0.723427331887,2,0.0365900862034,3,7,0.744868035191,0,0.0,-1,0,-0.0214407033034,2,0.0365900862034,tie
24,5,3,9,0.93924231594,1,0.0146294086854,5,9,0.934586466165,2,0.0646616541353,-2,0,0.00465584977454,-1,-0.0500322454499,different
12,2,3,3,0.400805639476,3,0.0693067082964,1,1,0.103092783505,0,0.0,2,2,0.297712855971,3,0.0693067082964,tie
18,4,1,4,0.459172852598,4,0.0715504973055,1,4,0.417633410673,0,0.0,0,0,0.0415394419252,4,0.0715504973055,tie
12,2,4,6,0.766803840878,4,0.0602393664489,5,6,0.69431500466,0,0.0,-1,0,0.0724888362181,4,0.0602393664489,different
18,2,2,4,0.563247863248,3,0.0463270104534,2,2,0.423363711682,1,0.015069669353,0,2,0.139884151566,2,0.0312573411004,different
21,3,5,10,1.0,13,0.219065539125,4,7,0.816970546985,10,0.177330103277,1,3,0.183029453015,3,0.0417354358481,different
18,2,5,7,0.858725761773,13,0.090012254271,5,6,0.760660247593,2,0.0250193822684,0,1,0.09806551418,11,0.0649928720026,different
18,3,4,8,0.872180451128,6,0.0924993711043,3,9,0.924083769634,1,0.015871807076,1,-1,-0.0519033185057,5,0.0766275640283,tie
27,6,3,5,0.643824701195,0,0.0,3,6,0.709515859766,0,0.0,0,-1,-0.0656911585711,0,0.0,different
12,2,5,8,0.863782051282,10,0.168291571347,6,10,1.0,8,0.14401890996,-1,-2,-0.136217948718,2,0.0242726613865,different
21,4,5,9,0.931617055511,12,0.187678508944,3,8,0.838289962825,1,0.0169043595809,2,1,0.0933270926856,11,0.170774149363,tie
12,2,4,7,0.776902887139,6,0.101139309259,4,7,0.775965665236,1,0.01561295357,0,0,0.000937221903056,5,0.0855263556892,tie
19,4,2,2,0.25601750547,1,0.01845517477,3,5,0.593275488069,0,0.0,-1,-3,-0.337257982599,1,0.01845517477,tie
21,5,3,8,0.843028624192,6,0.0967744150044,4,8,0.843806104129,2,0.019591969969,-1,0,-0.000777479937205,4,0.0771824450355,tie
12,2,5,7,0.779220779221,8,0.120037335651,5,8,0.938428874735,4,0.0843286366853,0,-1,-0.159208095514,4,0.0357086989654,tie
30,6,2,4,0.45665961945,3,0.053492694735,2,6,0.699654775604,0,0.0,0,-2,-0.242995156154,3,0.053492694735,tie
27,5,3,5,0.598443579767,5,0.0775360536936,2,9,0.924017467249,0,0.0,1,-4,-0.325573887482,5,0.0775360536936,different
18,3,2,4,0.486,4,0.0820910780669,3,8,0.866666666667,5,0.0781887843957,-1,-4,-0.380666666667,-1,0.00390229367123,tie
31,5,4,10,1.0,4,0.0603828648855,5,10,1.0,2,0.0359916626583,-1,0,0.0,2,0.0243912022272,different
21,3,5,10,1.0,7,0.0944151530183,6,10,1.0,2,0.0459377559378,-1,0,0.0,5,0.0484773970805,tie
27,5,3,10,1.0,8,0.122821587703,2,8,0.822085889571,0,0.0,1,2,0.177914110429,8,0.122821587703,tie
27,5,3,3,0.314315352697,1,0.0174979561616,4,8,0.867479055598,0,0.0,-1,-5,-0.553163702901,1,0.0174979561616,different
15,3,3,3,0.379275653924,5,0.0827100147353,3,5,0.616740088106,1,0.0160256307569,0,-2,-0.237464434182,4,0.0666843839783,tie
24,4,3,10,1.0,1,0.0148355582584,4,6,0.716150081566,1,0.0148361263533,-1,4,0.283849918434,0,-5.68094876202e-07,different
21,4,4,8,0.844890510949,7,0.111017081377,4,8,0.862007168459,4,0.0731443466927,0,0,-0.0171166575099,3,0.0378727346846,tie
24,4,4,10,1.0,7,0.0881208576333,2,6,0.695538057743,1,0.0236761313927,2,4,0.304461942257,6,0.0644447262407,different
10,2,3,8,0.876702508961,14,0.200838096761,4,7,0.847769028871,6,0.0979702537183,-1,1,0.0289334800892,8,0.102867843043,tie
45,8,4,6,0.722448979592,5,0.0995099006145,2,9,1.0,0,0.0,2,-3,-0.277551020408,5,0.0995099006145,different
22,4,3,4,0.477551020408,2,0.0344245504893,2,4,0.474849094567,0,0.0,1,0,0.00270192584076,2,0.0344245504893,tie
14,3,4,8,0.861450692747,10,0.137690380321,5,7,0.793675889328,3,0.0240488681279,-1,1,0.0677748034185,7,0.113641512193,different
15,2,4,9,0.929401993355,7,0.125155923872,3,7,0.784653465347,1,0.0150075007501,1,2,0.144748528009,6,0.110148423122,tie
21,4,4,6,0.747399702823,11,0.122711103255,4,7,0.822448979592,6,0.0817860235003,0,-1,-0.0750492767687,5,0.0409250797548,different
30,4,2,9,0.921441774492,8,0.124717410276,4,10,1.0,1,0.0164756258235,-2,-1,-0.0785582255083,7,0.108241784452,different
15,3,6,10,1.0,6,0.0833042044751,5,9,0.93034427542,1,0.00653468229129,1,1,0.0696557245797,5,0.0767695221838,different
29,9,2,3,0.402255639098,3,0.0509422953294,1,2,0.205479452055,0,0.0,1,1,0.196776187043,3,0.0509422953294,tie
24,4,2,9,0.922445255474,5,0.0769526904187,4,8,0.858075040783,0,0.0,-2,1,0.0643702146914,5,0.0769526904187,tie
36,6,1,1,0.1,0,0.0,3,8,0.830739299611,0,0.0,-2,-7,-0.730739299611,0,0.0,different
19,4,4,9,0.932549019608,11,0.171634958816,4,9,0.933486238532,5,0.0710425354462,0,0,-0.000937218924267,6,0.10059242337,different
24,5,2,6,0.677419354839,1,0.0160038232825,3,4,0.592505854801,1,0.0141991341991,-1,2,0.0849135000378,0,0.00180468908339,tie
12,2,3,5,0.64038616251,5,0.13373927451,4,6,0.765023632681,6,0.0729101958136,-1,-1,-0.124637470171,-1,0.0608290786961,different
27,5,1,1,0.159340659341,0,0.0,3,6,0.681318681319,1,0.0166566766567,-2,-5,-0.521978021978,-1,-0.0166566766567,different
27,6,3,5,0.591738712776,2,0.0324073578094,4,7,0.779374471682,1,0.0153753938369,-1,-2,-0.187635758906,1,0.0170319639724,tie
21,3,2,5,0.559917355372,4,0.0697026022305,1,1,0.130965593785,1,0.0201876702654,1,4,0.428951761587,3,0.0495149319651,tie
36,8,1,5,0.587378640777,0,0.0,3,7,0.7841191067,1,0.015044740206,-2,-2,-0.196740465923,-1,-0.015044740206,different
27,6,3,6,0.666973321067,4,0.0620718665677,2,6,0.674157303371,0,0.0,1,0,-0.00718398230363,4,0.0620718665677,tie
36,6,3,9,0.925503943909,9,0.152634648404,5,10,1.0,1,0.0135942383476,-2,-1,-0.0744960560911,8,0.139040410056,tie
18,3,2,2,0.298969072165,0,0.0,3,3,0.460584588131,1,0.0161107979709,-1,-1,-0.161615515966,-1,-0.0161107979709,tie
30,4,3,7,0.776792908944,12,0.178982353241,3,5,0.538706256628,0,0.0,0,2,0.238086652317,12,0.178982353241,tie
36,8,3,8,0.856418918919,1,0.0142466467397,3,7,0.772449869224,2,0.0317159388127,0,1,0.0839690496949,-1,-0.017469292073,tie
12,3,5,10,1.0,12,0.145751340556,6,10,1.0,11,0.127747179827,-1,0,0.0,1,0.0180041607282,different
24,5,1,2,0.24678111588,0,0.0,3,4,0.517560073937,0,0.0,-2,-2,-0.270778958057,0,0.0,different
40,8,1,1,0.140449438202,0,0.0,4,6,0.680147058824,0,0.0,-3,-5,-0.539697620621,0,0.0,different
21,3,4,9,0.914876690533,13,0.219080953353,5,8,0.878745644599,14,0.246988913525,-1,1,0.0361310459337,-1,-0.0279079601728,different
18,3,2,2,0.23937360179,1,0.0188680422145,3,5,0.591133004926,1,0.0151616659203,-1,-3,-0.351759403136,0,0.00370637629423,tie
30,5,2,6,0.665024630542,6,0.103257824088,3,5,0.557477110885,0,0.0,-1,1,0.107547519657,6,0.103257824088,different
12,2,4,5,0.672825250192,8,0.113490216953,5,7,0.841463414634,4,0.05696621886,-1,-2,-0.168638164442,4,0.0565239980927,tie
30,5,1,4,0.460484720759,4,0.0710981232446,3,5,0.598337950139,0,0.0,-2,-1,-0.13785322938,4,0.0710981232446,different
15,2,3,4,0.493041749503,5,0.0889939175357,4,8,0.851154833191,2,0.0311190605801,-1,-4,-0.358113083688,3,0.0578748569555,different
42,5,2,2,0.241917502787,1,0.0188049383944,3,5,0.623702422145,3,0.0410522176785,-1,-3,-0.381784919358,-2,-0.0222472792841,different
12,2,2,5,0.575848303393,3,0.0505030830532,2,5,0.619256017505,0,0.0,0,0,-0.0434077141123,3,0.0505030830532,different
24,4,2,5,0.564102564103,4,0.0692021732914,4,7,0.853164556962,0,0.0,-2,-2,-0.289061992859,4,0.0692021732914,tie
24,4,2,5,0.570707070707,0,0.0,3,5,0.655581947743,0,0.0,-1,0,-0.0848748770364,0,0.0,tie
28,4,2,6,0.666015625,2,0.0399737163104,4,8,0.832692307692,0,0.0,-2,-2,-0.166676682692,2,0.0399737163104,tie
27,5,3,3,0.369034994698,7,0.129441354216,3,8,0.841240875912,0,0.0,0,-5,-0.472205881215,7,0.129441354216,different
12,2,3,6,0.732704402516,3,0.06931098174,2,4,0.432768361582,0,0.0,1,2,0.299936040934,3,0.06931098174,tie
27,6,2,8,0.885714285714,0,0.0,2,8,0.834600760456,0,0.0,0,0,0.051113525258,0,0.0,different
17,4,3,5,0.652209492635,4,0.0798769766183,2,7,0.830618892508,2,0.0315368670418,1,-2,-0.178409399873,2,0.0483401095765,tie
24,4,4,5,0.613841524574,1,0.0169187860981,4,9,0.923144876325,4,0.0579906842274,0,-4,-0.309303351751,-3,-0.0410718981294,tie
24,4,3,4,0.507692307692,4,0.0834751215327,2,3,0.418338108883,0,0.0,1,1,0.0893541988098,4,0.0834751215327,tie
15,3,2,6,0.67803030303,6,0.0958410780669,4,7,0.878745644599,4,0.0830357934748,-2,-1,-0.200715341569,2,0.0128052845921,tie
30,4,2,3,0.376310272537,1,0.0176813728928,3,8,0.846830985915,0,0.0,-1,-5,-0.470520713379,1,0.0176813728928,tie
21,3,3,5,0.555028462998,0,0.0,4,8,0.86594761171,1,0.0140131671102,-1,-3,-0.310919148712,-1,-0.0140131671102,tie
18,2,3,6,0.690909090909,6,0.153261236904,2,5,0.629787234043,6,0.0714305609284,1,1,0.0611218568665,0,0.0818306759759,tie
12,2,4,10,1.0,12,0.182854039268,3,10,1.0,8,0.12378170638,1,0,0.0,4,0.0590723328887,tie
25,6,4,9,0.945054945055,11,0.172054853925,4,7,0.761643835616,1,0.0166110419261,0,2,0.183411109439,10,0.155443811999,tie
18,3,5,9,0.934665641814,17,0.250170729407,5,10,1.0,9,0.17354981278,0,-1,-0.065334358186,8,0.0766209166274,tie
9,2,4,4,0.511029411765,3,0.0657305789416,4,6,0.756473058083,2,0.0234976779693,0,-2,-0.245443646318,1,0.0422329009723,tie
27,5,2,2,0.279260780287,0,0.0,3,5,0.644317252657,1,0.0148725191407,-1,-3,-0.36505647237,-1,-0.0148725191407,tie
29,6,3,7,0.760563380282,3,0.0475155767318,3,7,0.755846585594,0,0.0,0,0,0.00471679468768,3,0.0475155767318,tie
30,4,1,1,0.177419354839,0,0.0,4,8,0.840659340659,0,0.0,-3,-7,-0.663239985821,0,0.0,tie
11,2,4,9,0.937407952872,5,0.064467207954,3,8,0.931388012618,4,0.0939718956123,1,1,0.00601994025357,1,-0.0295046876583,different
9,2,5,10,1.0,17,0.184360917172,5,8,0.874095513748,4,0.0877305617682,0,2,0.125904486252,13,0.0966303554036,tie
9,2,7,9,0.94498381877,7,0.130948857689,5,8,0.911224489796,10,0.179125231911,2,1,0.0337593289743,-3,-0.0481763742216,tie
24,2,2,2,0.306324110672,0,0.0,3,3,0.460584588131,1,0.0161107979709,-1,-1,-0.154260477459,-1,-0.0161107979709,tie
15,3,3,9,0.940434477926,7,0.0883375058289,4,8,1.0,2,0.0351374584381,-1,1,-0.0595655220743,5,0.0532000473908,tie
21,3,4,9,0.93924231594,16,0.198351982696,5,10,1.0,2,0.0242266824085,-1,-1,-0.06075768406,14,0.174125300288,tie
46,10,2,7,0.780361757106,10,0.166985261392,2,6,0.669829222011,4,0.0774469553217,0,1,0.110532535095,6,0.08953830607,tie
26,5,2,4,0.458598726115,3,0.0575399174421,3,5,0.586894586895,2,0.0345471812138,-1,-1,-0.12829586078,1,0.0229927362283,different
24,4,6,9,0.939111747851,13,0.204053535859,5,9,0.94264996704,10,0.133061664769,1,0,-0.00353821918921,3,0.0709918710902,tie
30,6,4,9,0.933176100629,10,0.144633630263,3,10,1.0,2,0.0354563175616,1,-1,-0.0668238993711,8,0.109177312702,tie
24,4,3,6,0.691891891892,2,0.030392846378,3,6,0.6925795053,0,0.0,0,0,-0.000687613408461,2,0.030392846378,tie
27,5,2,6,0.700371057514,9,0.154180259464,3,4,0.551546391753,6,0.101380818494,-1,2,0.148824665761,3,0.0527994409702,different
27,5,4,6,0.671794871795,3,0.0432513583071,3,10,1.0,0,0.0,1,-4,-0.328205128205,3,0.0432513583071,different
28,5,3,7,0.794022617124,6,0.103188377945,2,9,1.0,0,0.0,1,-2,-0.205977382876,6,0.103188377945,different
45,7,1,7,0.748272458045,7,0.116560916267,2,9,0.913946587537,3,0.0456649581872,-1,-2,-0.165674129492,4,0.0708959580798,tie
24,4,3,8,0.853223593964,12,0.118984604872,3,7,0.792692613185,1,0.0144472525092,0,1,0.0605309807793,11,0.104537352363,tie
21,3,1,5,0.621886120996,8,0.145669343423,4,6,0.693931398417,5,0.0877908371312,-3,-1,-0.0720452774204,3,0.0578785062918,different
12,2,3,9,0.931118314425,12,0.189913419653,5,9,0.941586748038,4,0.0711674724578,-2,0,-0.0104684336137,8,0.118745947195,tie
12,2,4,8,0.853321829163,9,0.143404935032,5,10,1.0,6,0.0861771747805,-1,-2,-0.146678170837,3,0.0572277602519,tie
30,5,2,7,0.765193370166,5,0.0776612787283,3,5,0.546402502607,0,0.0,-1,2,0.218790867559,5,0.0776612787283,tie
13,3,4,6,0.746457867263,5,0.0689742161013,5,9,1.0,5,0.0980671910249,-1,-3,-0.253542132737,0,-0.0290929749237,tie
25,4,2,5,0.582514734774,2,0.0331395476224,3,5,0.565434565435,1,0.0181709199891,-1,0,0.0170801693395,1,0.0149686276332,tie
33,5,5,8,0.88218988219,6,0.128389327274,5,7,0.816590563166,4,0.0862557077626,0,1,0.065599319024,2,0.0421336195115,tie
18,3,3,6,0.721405228758,4,0.0551242801953,4,7,0.828063241107,2,0.0137788956761,-1,-1,-0.106658012349,2,0.0413453845192,different
27,4,3,8,0.853321829163,11,0.175617680926,2,10,1.0,3,0.0526766739754,1,-2,-0.146678170837,8,0.122941006951,tie
12,2,5,9,0.934159566228,6,0.11166957979,4,9,0.94219269103,6,0.102784657203,1,0,-0.00803312480217,0,0.00888492258705,tie
18,5,4,10,1.0,6,0.0947852318095,3,8,0.834914611006,1,0.017257202001,1,2,0.165085388994,5,0.0775280298084,tie
15,2,2,10,1.0,12,0.192119193464,4,10,1.0,14,0.0675933853773,-2,0,0.0,-2,0.124525808086,different
21,5,3,6,0.662027833002,4,0.0670697007546,3,10,1.0,1,0.0164458326484,0,-4,-0.337972166998,3,0.0506238681062,tie
31,5,3,9,0.93002441009,12,0.183000051422,4,10,1.0,5,0.0827679782904,-1,-1,-0.0699755899105,7,0.100232073131,tie
18,4,2,4,0.507218479307,3,0.052168048345,3,5,0.572271386431,0,0.0,-1,-1,-0.0650529071237,3,0.052168048345,tie
15,2,5,10,1.0,21,0.243705722957,5,9,0.947872977831,15,0.179072934256,0,1,0.052127022169,6,0.0646327887009,different
12,2,1,1,0.124571428571,1,0.019277748274,2,3,0.371270718232,0,0.0,-1,-2,-0.246699289661,1,0.019277748274,tie
21,6,1,1,0.117903930131,0,0.0,3,6,0.658823529412,0,0.0,-2,-5,-0.540919599281,0,0.0,different
12,2,3,8,0.877521613833,6,0.0729165550711,4,5,0.677299703264,2,0.0269867817642,-1,3,0.200221910569,4,0.0459297733069,tie
12,1,5,8,0.84022556391,1,0.0192354725103,1,3,0.44590780809,3,0.0716531258018,4,5,0.394317755819,-2,-0.0524176532915,different
11,3,3,8,0.858215179316,11,0.173510453259,6,10,1.0,5,0.0748823569529,-3,-2,-0.141784820684,6,0.0986280963059,tie
15,2,4,10,1.0,13,0.151643112842,7,10,1.0,20,0.232114624506,-3,0,0.0,-7,-0.0804715116639,tie
22,4,2,9,0.930441898527,12,0.18625691322,3,3,0.472727272727,0,0.0,-1,6,0.4577146258,12,0.18625691322,different
26,4,3,4,0.453376205788,3,0.0580949648773,2,7,0.727272727273,1,0.0213242139261,1,-3,-0.273896521485,2,0.0367707509512,tie
18,3,6,6,0.727418065548,5,0.0853473355145,4,6,0.705583756345,1,0.0153884017843,2,0,0.0218343092024,4,0.0699589337301,tie
26,6,2,3,0.376310272537,1,0.0176813728928,2,5,0.602109300096,0,0.0,0,-2,-0.225799027559,1,0.0176813728928,tie
25,4,3,9,0.920740740741,6,0.0749690210657,4,7,0.784830997527,1,0.0149951285318,-1,2,0.135909743214,5,0.0599738925339,different
24,4,4,9,0.934514637904,15,0.218175230982,6,9,0.936588921283,6,0.0924781341108,-2,0,-0.00207428337833,9,0.125697096871,tie
21,4,3,8,0.840531561462,10,0.155043905692,5,8,0.877777777778,5,0.0792207792208,-2,0,-0.037246216316,5,0.0758231264715,different
12,2,4,10,1.0,14,0.203253656672,5,10,1.0,9,0.180746298653,-1,0,0.0,5,0.0225073580189,tie
18,3,3,6,0.69884853853,10,0.123776345814,4,9,0.928336079077,1,0.0149827766961,-1,-3,-0.229487540548,9,0.108793569118,tie
45,5,3,4,0.496544916091,2,0.0333031189334,3,3,0.463436123348,2,0.0320512615138,0,1,0.0331087927428,0,0.0012518574196,tie
15,2,3,7,0.782608695652,9,0.142460313687,4,6,0.7,3,0.0446269592476,-1,1,0.0826086956522,6,0.0978333544398,different
12,2,3,5,0.573879885605,6,0.100999004185,2,6,0.638253638254,1,0.0189075789076,1,-1,-0.0643737526483,5,0.0820914252777,tie
18,3,0,0,0.0,0,0.0,3,5,0.545454545455,1,0.0190063645863,-3,-5,-0.545454545455,-1,-0.0190063645863,tie
18,4,1,1,0.177419354839,0,0.0,3,4,0.527173913043,0,0.0,-2,-3,-0.349754558205,0,0.0,different
30,4,3,3,0.437086092715,1,0.0159584008891,4,4,0.547660311958,1,0.0157617772176,-1,-1,-0.110574219243,0,0.000196623671515,tie
12,2,3,7,0.749015748031,5,0.0830119573808,6,9,0.931225296443,1,0.0143787279914,-3,-2,-0.182209548411,4,0.0686332293894,tie
14,3,5,10,1.0,3,0.0506505576208,4,9,1.0,2,0.0269500854052,1,1,0.0,1,0.0237004722156,tie
28,6,3,8,0.847048300537,6,0.0937448045168,2,4,0.508474576271,0,0.0,1,4,0.338573724265,6,0.0937448045168,tie
21,4,3,7,0.785353535354,9,0.152020514939,4,10,1.0,5,0.0846634281749,-1,-3,-0.214646464646,4,0.0673570867639,different
18,3,2,3,0.39898989899,0,0.0,3,4,0.572131147541,1,0.0149090909091,-1,-1,-0.173141248551,-1,-0.0149090909091,different
20,4,5,8,0.837320574163,6,0.103737037762,3,10,1.0,0,0.0,2,-2,-0.162679425837,6,0.103737037762,different
18,3,2,6,0.663896583564,6,0.093451688309,3,6,0.648068669528,1,0.0165119001171,-1,0,0.0158279140363,5,0.076939788192,tie
18,2,2,3,0.332251082251,2,0.0365108868826,6,9,0.936956521739,3,0.0343886693017,-4,-6,-0.604705439488,-1,0.00212221758092,different
18,3,3,10,1.0,6,0.0599254861586,3,9,0.952380952381,16,0.223324874359,0,1,0.047619047619,-10,-0.163399388201,tie
21,4,2,4,0.528214616096,3,0.0636647190919,2,7,0.825534759358,4,0.0420503159942,0,-3,-0.297320143262,-1,0.0216144030977,tie
30,5,2,8,0.847942754919,7,0.105613781913,4,9,0.925957446809,2,0.0309601547389,-2,-1,-0.078014691889,5,0.0746536271739,tie
12,2,4,6,0.739063699156,2,0.0371105284631,5,10,1.0,4,0.0745193018364,-1,-4,-0.260936300844,-2,-0.0374087733733,tie
24,4,5,9,0.936614466816,10,0.137527063252,3,7,0.766756032172,1,0.0162547729304,2,2,0.169858434644,9,0.121272290322,tie
15,2,3,3,0.371900826446,2,0.0309789343247,5,9,0.933890577508,2,0.0276429953026,-2,-6,-0.561989751061,0,0.00333593902209,tie
24,3,1,2,0.242491657397,2,0.0375262063176,2,8,0.831067961165,0,0.0,-1,-6,-0.588576303768,2,0.0375262063176,tie
25,6,2,10,1.0,1,0.0151418579352,4,7,0.807663964628,8,0.0947330340993,-2,3,0.192336035372,-7,-0.0795911761641,different
18,3,2,5,0.609375,9,0.154177714301,3,5,0.578079534433,1,0.017642183229,-1,0,0.0312954655674,8,0.136535531072,tie
39,6,5,9,0.931836407378,11,0.170681755172,5,10,1.0,2,0.0308289676425,0,-1,-0.0681635926223,9,0.139852787529,different
18,3,3,9,0.937774524158,14,0.213603607526,3,9,0.924479166667,0,0.0,0,0,0.0132953574915,14,0.213603607526,tie
12,2,6,10,1.0,14,0.264816382932,8,10,1.0,8,0.115074288592,-2,0,0.0,6,0.14974209434,different
27,7,2,6,0.669253152279,5,0.0818042179427,3,7,0.750716332378,0,0.0,-1,-1,-0.0814631800989,5,0.0818042179427,tie
27,4,1,2,0.303278688525,0,0.0,3,3,0.499589153657,1,0.014945842982,-2,-1,-0.196310465132,-1,-0.014945842982,tie
15,3,3,6,0.667279411765,3,0.0498185682265,6,10,1.0,1,0.0143901035673,-3,-4,-0.332720588235,2,0.0354284646592,different
24,6,4,8,0.843893480257,7,0.128944053581,4,5,0.581328200192,0,0.0,0,3,0.262565280065,7,0.128944053581,different
24,5,4,8,0.855574324324,9,0.146455528484,5,9,0.9375,8,0.121266980146,-1,-1,-0.0819256756757,1,0.0251885483376,tie
25,5,4,4,0.578860445912,1,0.0139290088685,5,10,1.0,1,0.0122238514174,-1,-6,-0.421139554088,0,0.00170515745112,different
11,3,5,9,0.937865497076,7,0.132266462314,4,10,1.0,6,0.147147860515,1,-1,-0.062134502924,1,-0.0148813982003,tie
30,5,4,10,1.0,12,0.184295316234,3,7,0.75023923445,5,0.0925863418878,1,3,0.24976076555,7,0.0917089743466,tie
12,2,5,8,0.878637331441,6,0.0959326791919,4,8,1.0,2,0.137831961485,1,0,-0.121362668559,4,-0.0418992822928,different
12,2,5,9,0.929092113983,13,0.190374481734,4,10,1.0,22,0.191719781727,1,-1,-0.0709078860172,-9,-0.00134529999265,tie
9,1,5,9,0.933645589383,12,0.202184341346,7,10,1.0,6,0.103301673451,-2,-1,-0.0663544106167,6,0.0988826678948,different
24,4,3,10,1.0,14,0.184154578808,4,7,0.797987616099,10,0.170025330706,-1,3,0.202012383901,4,0.0141292481015,tie
9,2,3,7,0.770403587444,10,0.164192241652,5,10,1.0,6,0.0825535168196,-2,-3,-0.229596412556,4,0.0816387248328,different
30,5,3,7,0.776511831727,6,0.0898839796826,3,6,0.668571428571,1,0.0173229437229,0,1,0.107940403155,5,0.0725610359597,tie
21,2,3,7,0.788907284768,0,0.0,5,7,0.787804878049,1,0.0147878787879,-2,0,0.00110240671943,-1,-0.0147878787879,tie
24,3,3,8,0.858215179316,9,0.15362709321,3,9,0.915451895044,4,0.0793285625939,0,-1,-0.0572367157276,5,0.0742985306158,tie
27,6,1,2,0.246516613076,0,0.0,1,3,0.362715298886,0,0.0,0,-1,-0.116198685809,0,0.0,tie
21,4,2,4,0.526462395543,8,0.194268120519,3,7,0.739260739261,0,0.0,-1,-3,-0.212798343718,8,0.194268120519,different
28,5,4,6,0.684308263695,4,0.0857382996276,2,5,0.591937069813,0,0.0,2,1,0.0923711938823,4,0.0857382996276,different
30,6,3,8,0.830985915493,6,0.0890917063721,3,7,0.781954887218,2,0.0303911293385,0,1,0.0490310282749,4,0.0587005770336,tie
29,5,2,7,0.743718592965,6,0.10171676225,3,9,0.917221693625,0,0.0,-1,-2,-0.17350310066,6,0.10171676225,tie
18,3,5,9,0.934261407579,12,0.194224261609,4,8,0.856198347107,3,0.0802554470323,1,1,0.0780630604718,9,0.113968814577,different
9,1,3,4,0.536363636364,0,0.0,3,6,0.666026871401,0,0.0,0,-2,-0.129663235038,0,0.0,tie
18,3,2,5,0.556476683938,4,0.0699192942581,4,9,0.929153094463,3,0.0444358898431,-2,-4,-0.372676410525,1,0.0254834044151,different
9,1,6,8,0.878397711016,8,0.111296807441,6,10,1.0,12,0.167062861626,0,-2,-0.121602288984,-4,-0.0557660541846,tie
18,3,4,10,1.0,13,0.183476814713,4,9,0.944726810673,9,0.0717338569943,0,1,0.0552731893266,4,0.111742957719,tie
24,3,2,3,0.41437007874,0,0.0,4,6,0.730650154799,1,0.0140782437377,-2,-3,-0.316280076059,-1,-0.0140782437377,tie
16,4,2,9,0.921875,8,0.12402963044,5,7,0.823050847458,10,0.136850539291,-3,2,0.0988241525424,-2,-0.0128209088517,different
14,3,3,3,0.409900990099,1,0.0167010195443,4,10,1.0,0,0.0,-1,-7,-0.590099009901,1,0.0167010195443,tie
30,6,3,4,0.49604743083,4,0.0901689025376,4,9,0.924544666088,4,0.0857841204762,-1,-5,-0.428497235258,0,0.00438478206135,different
18,2,4,8,0.863563402889,6,0.117146616384,4,9,1.0,0,0.0,0,-1,-0.136436597111,6,0.117146616384,tie
9,2,5,9,0.933787128713,13,0.154409667268,3,9,0.931225296443,2,0.0305109593963,2,0,0.00256183227018,11,0.123898707872,different
15,3,3,4,0.480651731161,3,0.0551961326176,3,8,0.87015503876,0,0.0,0,-4,-0.389503307599,3,0.0551961326176,different
18,3,3,5,0.66976744186,2,0.0261519840927,4,7,0.881793478261,3,0.0370701581028,-1,-2,-0.2120260364,-1,-0.0109181740101,tie
9,2,4,9,0.931617055511,12,0.190347731684,5,8,0.883685800604,6,0.0806701455644,-1,1,0.0479312549066,6,0.10967758612,different
24,4,4,7,0.756679389313,3,0.0482863446749,2,3,0.340195016251,0,0.0,2,4,0.416484373062,3,0.0482863446749,different
34,8,3,9,0.912653061224,10,0.155938092709,1,9,0.905945945946,1,0.0196638820639,2,0,0.00670711527854,9,0.136274210645,tie
15,2,3,8,0.847619047619,5,0.0760945890128,5,9,0.93829787234,9,0.111651837524,-2,-1,-0.0906788247214,-4,-0.0355572485114,different
10,2,3,9,0.921731123389,8,0.124258045965,4,7,0.748432601881,0,0.0,-1,2,0.173298521508,8,0.124258045965,tie
12,2,5,8,0.852045256745,7,0.107070638441,6,10,1.0,1,0.01325735489,-1,-2,-0.147954743255,6,0.093813283551,tie
9,2,4,7,0.77893056664,4,0.0655156249536,3,8,0.835538752363,0,0.0,1,-1,-0.0566081857229,4,0.0655156249536,different
27,4,2,2,0.25601750547,1,0.01845517477,2,3,0.324084350721,0,0.0,0,-1,-0.068066845251,1,0.01845517477,tie
36,8,2,4,0.469430051813,3,0.0524394706936,2,6,0.6925795053,0,0.0,0,-2,-0.223149453487,3,0.0524394706936,tie
30,7,3,9,0.930098684211,11,0.165166124535,3,9,0.911854103343,0,0.0,0,0,0.0182445808671,11,0.165166124535,different
27,4,4,5,0.613636363636,6,0.105910780669,4,6,0.717073170732,1,0.0147878787879,0,-1,-0.103436807095,5,0.0911229018813,different
27,8,1,5,0.560041407867,5,0.0873086425454,5,8,0.863422291994,1,0.01427715142,-4,-3,-0.303380884126,4,0.0730314911254,tie
9,1,6,10,1.0,15,0.240347396443,6,9,0.949826989619,11,0.149562755584,0,1,0.0501730103806,4,0.0907846408594,tie
25,5,4,10,1.0,13,0.189513963123,4,10,1.0,13,0.172506265664,0,0,0.0,0,0.0170076974589,different
12,2,3,3,0.40380761523,2,0.0374093912733,4,5,0.618755477651,0,0.0,-1,-2,-0.214947862421,2,0.0374093912733,tie
10,2,3,7,0.803695150115,5,0.0760078527664,4,8,0.820247933884,0,0.0,-1,-1,-0.0165527837688,5,0.0760078527664,different
15,2,6,10,1.0,13,0.190953536864,5,10,1.0,8,0.160588864423,1,0,0.0,5,0.0303646724413,tie
18,3,5,9,0.932806324111,13,0.205583554961,6,9,0.939330543933,7,0.171616584253,-1,0,-0.00652421982238,6,0.0339669707087,tie
15,2,5,9,0.947627849661,9,0.104624049731,6,7,0.843806104129,5,0.0544257657364,-1,2,0.103821745532,4,0.0501982839949,tie
12,2,6,9,0.941338854382,8,0.106398208225,6,9,0.930787589499,3,0.0551717653866,0,0,0.0105512648835,5,0.0512264428381,tie
24,3,1,2,0.286463798531,0,0.0,3,6,0.672932330827,0,0.0,-2,-4,-0.386468532296,0,0.0,tie
18,3,2,8,0.829484902309,8,0.119843905789,2,4,0.47032967033,0,0.0,0,4,0.359155231979,8,0.119843905789,tie
28,5,2,6,0.688073394495,8,0.133706217387,2,5,0.602012808783,4,0.0746835232471,0,1,0.0860605857122,4,0.0590226941397,tie
12,3,2,3,0.40618762475,2,0.0384454140047,3,3,0.452830188679,1,0.0163423997386,-1,0,-0.0466425639287,1,0.0221030142661,tie
30,6,3,3,0.334451901566,1,0.0188680422145,3,7,0.77519379845,4,0.130921619294,0,-4,-0.440741896884,-3,-0.112053577079,different
21,3,1,10,1.0,13,0.206251981211,4,9,0.942041522491,5,0.0863479081472,-3,1,0.0579584775087,8,0.119904073064,tie
18,3,3,3,0.522388059701,3,0.105414686173,4,6,0.835074626866,4,0.0889226594301,-1,-3,-0.312686567164,-1,0.0164920267425,different
15,3,2,6,0.681338028169,1,0.0148486177287,2,7,0.786885245902,0,0.0,0,-1,-0.105547217733,1,0.0148486177287,different
15,2,7,9,0.942914707858,16,0.195332063384,8,9,0.950958286359,10,0.192004714564,-1,0,-0.00804357850089,6,0.00332734882037,different
30,5,1,2,0.286463798531,0,0.0,3,7,0.755617977528,2,0.027403813415,-2,-5,-0.469154178997,-2,-0.027403813415,different
30,4,3,10,1.0,11,0.170363373483,3,8,0.855721393035,3,0.0391738278305,0,2,0.144278606965,8,0.131189545652,different
37,6,4,4,0.453475935829,1,0.0180406735185,3,5,0.616740088106,1,0.0160256307569,1,-1,-0.163264152277,0,0.00201504276157,tie
24,4,4,9,0.932432432432,11,0.165372840586,5,8,0.867881548975,6,0.0896030924277,-1,1,0.0645508834575,5,0.0757697481584,different
15,3,4,6,0.679849340866,2,0.0351549646805,6,8,0.857025472473,2,0.029891685964,-2,-2,-0.177176131607,0,0.00526327871652,tie
12,2,4,8,0.870466321244,8,0.114101996135,5,8,0.879025923016,1,0.0142883667785,-1,0,-0.00855960177297,7,0.0998136293563,different
18,3,3,5,0.560041407867,4,0.0735720827849,2,4,0.43963963964,0,0.0,1,1,0.120401768228,4,0.0735720827849,tie
18,3,5,10,1.0,12,0.171690108756,5,10,1.0,9,0.114117781589,0,0,0.0,3,0.057572327166,tie
14,3,2,10,1.0,5,0.0705622018387,3,4,0.57094017094,6,0.105827505828,-1,6,0.42905982906,-1,-0.0352653039888,different
21,3,5,8,0.890534449453,10,0.118306814727,5,8,0.882985877606,11,0.142720547778,0,0,0.00754857184675,-1,-0.0244137330505,tie
28,7,1,4,0.46088794926,4,0.07132359298,1,2,0.205479452055,0,0.0,0,2,0.255408497205,4,0.07132359298,tie
15,4,2,7,0.756628787879,6,0.0958410780669,3,6,0.661478599222,1,0.0176936681995,-1,1,0.095150188657,5,0.0781474098674,different
12,2,4,10,1.0,10,0.135020130948,5,9,0.95524691358,14,0.144683875795,-1,1,0.0447530864198,-4,-0.00966374484735,tie
30,6,2,3,0.436018957346,1,0.0257950281013,3,5,0.638103161398,1,0.0151323551656,-1,-2,-0.202084204052,0,0.0106626729356,different
9,2,5,10,1.0,15,0.180569704426,6,10,1.0,5,0.110178665265,-1,0,0.0,10,0.0703910391603,tie
15,2,7,10,1.0,17,0.23464626863,6,9,1.0,8,0.124543914583,1,1,0.0,9,0.110102354046,different
30,3,1,1,0.177419354839,0,0.0,3,3,0.437673130194,1,0.0167950977923,-2,-2,-0.260253775355,-1,-0.0167950977923,different
12,2,4,5,0.640963855422,3,0.0446201161523,4,7,0.783222591362,1,0.015107218363,0,-2,-0.14225873594,2,0.0295128977893,tie
9,1,5,8,0.880197322058,6,0.100328520792,5,9,1.0,2,0.137831961485,0,-1,-0.119802677942,4,-0.0375034406928,different
24,4,2,6,0.669902912621,5,0.0818836395135,3,7,0.852417302799,4,0.101065618012,-1,-1,-0.182514390178,1,-0.0191819784987,tie
18,3,5,8,0.84578313253,11,0.16461981756,5,7,0.761643835616,1,0.0166110419261,0,1,0.0841392969137,10,0.148008775634,different
15,3,3,9,0.930725346373,11,0.169550964513,3,8,0.840073529412,1,0.0167179144385,0,1,0.0906518169615,10,0.152833050074,different
39,6,3,7,0.798895899054,6,0.0979090685211,2,9,1.0,2,0.137831961485,1,-2,-0.201104100946,4,-0.0399228929636,different
17,4,4,7,0.770315091211,8,0.124575388238,4,7,0.809070958303,5,0.0713972201902,0,0,-0.0387558670922,3,0.0531781680483,different
27,4,3,9,0.920411985019,7,0.110558247358,4,8,0.873454545455,1,0.0132284297521,-1,1,0.0469574395642,6,0.097329817606,different
27,4,3,4,0.581280788177,2,0.0276979141868,4,4,0.606037735849,1,0.0137276157804,-1,0,-0.0247569476717,1,0.0139702984064,different
21,3,5,10,1.0,14,0.195013361686,7,10,1.0,6,0.0863068589702,-2,0,0.0,8,0.108706502716,tie
24,4,3,10,1.0,8,0.134427210187,4,10,1.0,5,0.0808899366436,-1,0,0.0,3,0.0535372735431,tie
15,2,3,5,0.622466216216,1,0.00883056616096,5,8,0.874388254486,1,0.0148361263533,-2,-3,-0.25192203827,0,-0.0060055601923,different
30,6,5,9,0.931340872375,12,0.226585630979,2,10,1.0,9,0.213116883117,3,-1,-0.0686591276252,3,0.0134687478625,tie
24,3,4,9,0.938001458789,12,0.160369198398,4,7,0.770851624232,1,0.0159693511054,0,2,0.167149834557,11,0.144399847293,different
13,3,4,10,1.0,10,0.131242355198,4,9,0.928805237316,4,0.0687576253534,0,1,0.0711947626841,6,0.0624847298451,tie
12,2,4,8,0.873039581777,6,0.103635293497,4,9,0.933128362798,2,0.015951366082,0,-1,-0.0600887810204,4,0.087683927415,tie
21,3,3,6,0.771965124078,5,0.0588288092869,5,9,0.938210227273,6,0.0245402892562,-2,-3,-0.166245103195,-1,0.0342885200308,tie
18,3,4,8,0.862570735651,10,0.148725931847,6,9,0.928276999176,1,0.0149951285318,-2,-1,-0.0657062635248,9,0.133730803316,different
15,3,4,7,0.784991568297,9,0.15550066764,6,10,1.0,5,0.0824764276819,-2,-3,-0.215008431703,4,0.0730242399585,different
18,3,2,10,1.0,9,0.134648307572,3,10,1.0,4,0.071105479886,-1,0,0.0,5,0.0635428276859,different
15,3,5,9,0.927966101695,7,0.1031141705,6,7,0.880821917808,4,0.0816139476961,-1,2,0.0471441838867,3,0.0215002228035,tie
21,3,4,10,1.0,1,0.0217601857965,3,7,0.783761391881,1,0.015069669353,1,3,0.216238608119,0,0.00669051644352,different
27,5,3,8,0.857740585774,7,0.118523588061,3,8,0.862232779097,9,0.194958612251,0,0,-0.00449219332333,-2,-0.0764350241902,tie
17,3,3,8,0.835907335907,6,0.0976912919292,4,9,0.914454277286,0,0.0,-1,-1,-0.0785469413788,6,0.0976912919292,tie
16,3,2,10,1.0,13,0.200388506308,3,6,0.699481865285,5,0.0861987753179,-1,4,0.300518134715,8,0.11418973099,tie
25,4,4,9,0.939886845827,10,0.148241430622,4,9,0.933435348125,5,0.0763719830284,0,0,0.00645149770196,5,0.0718694475936,different
21,4,3,6,0.694444444444,8,0.125521312174,3,6,0.666026871401,0,0.0,0,0,0.0284175730433,8,0.125521312174,different
17,2,3,10,1.0,13,0.175172638935,4,7,0.877291960508,5,0.0968585716117,-1,3,0.122708039492,8,0.0783140673229,different
24,4,1,5,0.547570850202,5,0.0853645229746,2,4,0.459051724138,0,0.0,-1,1,0.0885191260645,5,0.0853645229746,tie
12,2,6,8,0.879773691655,12,0.180159372815,5,10,1.0,11,0.190412129234,1,-2,-0.120226308345,1,-0.0102527564195,tie
25,5,2,2,0.386952636282,0,0.0,3,3,0.460584588131,1,0.0161107979709,-1,-1,-0.0736319518487,-1,-0.0161107979709,tie
16,3,4,7,0.764566929134,9,0.131579486579,5,9,0.916586768936,0,0.0,-1,-2,-0.152019839802,9,0.131579486579,different
9,1,5,8,0.860179885527,6,0.0892801235307,5,9,0.965935787001,14,0.0573246956646,0,-1,-0.105755901473,-8,0.0319554278662,different
24,4,2,9,0.920037629351,9,0.142814927242,4,7,0.783761391881,1,0.015069669353,-2,2,0.13627623747,8,0.127745257889,tie
18,5,3,4,0.519774011299,3,0.0614152997431,3,8,0.90946930281,0,0.0,0,-4,-0.38969529151,3,0.0614152997431,tie
18,3,1,5,0.559585492228,5,0.0873991178227,2,5,0.552929085303,0,0.0,-1,0,0.00665640692479,5,0.0873991178227,tie
18,3,3,7,0.765625,3,0.0465111114148,5,6,0.731895223421,1,0.0140131671102,-2,1,0.0337297765794,2,0.0324979443046,tie
24,4,1,5,0.562306900103,5,0.0868590614819,2,4,0.488798370672,2,0.0313423440104,-1,1,0.0735085294309,3,0.0555167174715,tie
9,1,3,7,0.764542936288,4,0.0718539647887,3,10,1.0,1,0.0362257792755,0,-3,-0.235457063712,3,0.0356281855132,tie
15,3,4,9,0.945742904841,8,0.110292246681,2,8,0.852166525064,1,0.0154537730748,2,1,0.0935763797777,7,0.0948384736064,tie
12,2,3,8,0.895641497851,18,0.259490507781,4,9,0.93502613891,10,0.159261321203,-1,-1,-0.0393846410582,8,0.100229186578,different
33,7,1,1,0.119677790564,1,0.0194108512541,2,2,0.344061302682,0,0.0,-1,-1,-0.224383512118,1,0.0194108512541,tie
12,3,6,9,0.938405797101,5,0.0781221378159,6,9,0.945929148539,12,0.148579156574,0,0,-0.00752335143802,-7,-0.0704570187586,different
30,7,2,2,0.282426778243,0,0.0,2,3,0.438709677419,1,0.0167641390867,0,-1,-0.156282899177,-1,-0.0167641390867,different
13,3,5,8,0.877961234745,7,0.107123509208,4,10,1.0,3,0.0358455139632,1,-2,-0.122038765255,4,0.0712779952451,tie
21,3,4,8,0.849557522124,6,0.0959338092575,4,9,0.925449871465,3,0.0462600296019,0,-1,-0.0758923493414,3,0.0496737796556,tie
28,5,3,3,0.364572605561,1,0.0173718122964,4,8,0.847368421053,0,0.0,-1,-5,-0.482795815491,1,0.0173718122964,different
9,2,4,5,0.594078319007,6,0.102855387849,3,6,0.697391304348,1,0.0158166007905,1,-1,-0.103312985341,5,0.0870387870586,tie
30,6,2,6,0.628985507246,6,0.0977856796509,2,3,0.325581395349,0,0.0,0,3,0.303404111898,6,0.0977856796509,different
30,5,3,7,0.768468468468,4,0.060785692756,2,7,0.762078395624,0,0.0,1,0,0.00639007284404,4,0.060785692756,tie
24,4,4,4,0.539711191336,2,0.0349133708212,3,4,0.538461538462,1,0.0160823084961,1,0,0.0012496528742,1,0.0188310623251,tie
21,3,3,4,0.464847848898,3,0.056875763096,3,8,0.848432055749,2,0.0316883116883,0,-4,-0.383584206851,1,0.0251874514077,tie
12,2,6,9,0.928027095682,8,0.143212386957,4,7,0.716919739696,4,0.115858804969,2,2,0.211107355985,4,0.0273535819876,tie
14,3,4,9,0.933852140078,9,0.132143838688,4,10,1.0,5,0.0816842731736,0,-1,-0.0661478599222,4,0.0504595655141,tie
30,5,1,5,0.543010752688,0,0.0,4,4,0.536412078153,5,0.118049410625,-3,1,0.00659867453542,-5,-0.118049410625,tie
21,4,5,7,0.753384912959,1,0.0197935616547,5,8,0.863743148003,1,0.0142436107354,0,-1,-0.110358235044,0,0.00554995091928,tie
24,4,3,4,0.486921529175,1,0.0169698488328,4,8,0.85077186964,1,0.0155995633869,-1,-4,-0.363850340465,0,0.0013702854459,tie
19,4,2,7,0.757604562738,7,0.122501660848,3,10,1.0,1,0.0165055271407,-1,-3,-0.242395437262,6,0.105996133707,tie
12,2,4,7,0.798737174428,7,0.0923661255256,4,8,0.864801864802,1,0.0141329377693,0,-1,-0.0660646903741,6,0.0782331877563,tie
9,1,6,9,0.944078947368,11,0.154202944629,4,10,1.0,5,0.0810212514758,2,-1,-0.0559210526316,6,0.0731816931534,different
8,2,5,7,0.797169811321,9,0.129160237077,5,9,0.935459940653,0,0.0,0,-2,-0.138290129332,9,0.129160237077,different
27,5,2,2,0.424216765453,0,0.0,2,4,0.538869257951,0,0.0,0,-2,-0.114652492498,0,0.0,tie
8,2,5,6,0.725521669342,8,0.118317649937,4,6,0.78904109589,9,0.122759651308,1,0,-0.0635194265485,-1,-0.00444200137055,different
9,1,5,7,0.790812141099,7,0.111251223655,5,6,0.766548042705,4,0.091231316726,0,1,0.0242640983946,3,0.0200199069292,different
12,1,5,9,0.938136826783,10,0.163196755464,3,9,0.944194996793,3,0.0354119773748,2,0,-0.0060581700097,7,0.127784778089,tie
9,1,6,9,0.946372239748,9,0.120028613981,5,9,0.952549575071,5,0.0744244141128,1,0,-0.00617733532319,4,0.0456041998682,tie
36,7,4,10,1.0,15,0.162525685066,4,8,0.828063241107,0,0.0,0,2,0.171936758893,15,0.162525685066,tie
10,2,3,6,0.747041420118,7,0.103861001738,3,7,0.785714285714,0,0.0,0,-1,-0.0386728655959,7,0.103861001738,tie
28,6,5,6,0.694444444444,7,0.128897349802,4,6,0.7,1,0.0156802507837,1,0,-0.00555555555556,6,0.113217099018,tie
33,7,2,3,0.360215053763,0,0.0,3,7,0.739260739261,0,0.0,-1,-4,-0.379045685497,0,0.0,tie
15,2,4,9,0.937083641747,9,0.134677878702,4,10,1.0,6,0.083440211241,0,-1,-0.0629163582531,3,0.051237667461,different
30,4,3,6,0.648202137998,5,0.0848046069198,3,8,0.846965699208,4,0.0717933956984,0,-2,-0.19876356121,1,0.0130112112214,tie
21,4,2,2,0.221967963387,1,0.0192998051943,3,6,0.668571428571,5,0.0730701298701,-1,-4,-0.446603465185,-4,-0.0537703246759,different
12,2,5,10,1.0,5,0.0563388762649,3,9,0.939917127072,10,0.123825966851,2,1,0.0600828729282,-5,-0.0674870905859,tie
24,4,3,6,0.712351945854,2,0.0285415054819,4,7,0.817226890756,2,0.0340183346066,-1,-1,-0.104874944902,0,-0.00547682912471,different
18,3,2,3,0.391634980989,7,0.117444909325,4,5,0.660944206009,2,0.0288224736637,-2,-2,-0.26930922502,5,0.0886224356611,tie
16,4,1,9,0.919886899152,9,0.143084135399,4,9,0.925321888412,2,0.0312259071401,-3,0,-0.00543498926027,7,0.111858228259,tie
18,3,3,5,0.564862104188,1,0.0172298567311,4,6,0.688172043011,1,0.0162984685565,-1,-1,-0.123309938823,0,0.000931388174598,different
15,2,6,10,1.0,11,0.158995304246,5,10,1.0,6,0.0915654642387,1,0,0.0,5,0.067429840007,tie
12,2,5,8,0.852941176471,5,0.0716642440926,5,8,0.871301775148,4,0.0556764389457,0,0,-0.0183605986773,1,0.0159878051469,tie
29,5,2,6,0.661691542289,6,0.104285265124,3,6,0.654761904762,0,0.0,-1,0,0.00692963752665,6,0.104285265124,tie
12,2,5,5,0.685418208734,7,0.18025199563,5,6,0.714754098361,1,0.0149090909091,0,-1,-0.0293358896264,6,0.165342904721,tie
18,3,3,8,0.85593220339,9,0.146951987902,3,6,0.661478599222,0,0.0,0,2,0.194453604168,9,0.146951987902,tie
12,2,0,0,0.0,0,0.0,2,2,0.496694214876,4,0.0984763335838,-2,-2,-0.496694214876,-4,-0.0984763335838,different
21,3,3,5,0.663909774436,1,0.0126827291277,3,6,0.709515859766,0,0.0,0,-1,-0.0456060853302,1,0.0126827291277,tie
30,6,3,7,0.732883317261,5,0.0813309052063,4,9,0.916104146577,0,0.0,-1,-2,-0.183220829315,5,0.0813309052063,tie
18,2,3,10,1.0,9,0.126266867302,4,5,0.692144373673,9,0.128412790324,-1,5,0.307855626327,0,-0.00214592302174,different
30,6,1,4,0.46088794926,4,0.07132359298,3,5,0.601283226398,1,0.0166719440047,-2,-1,-0.140395277138,3,0.0546516489754,different
28,5,2,9,0.928810720268,14,0.190417701892,2,7,0.741071428571,6,0.102651515152,0,2,0.187739291697,8,0.0877661867408,different
17,3,1,6,0.664705882353,6,0.0992237043516,2,8,0.816842105263,1,0.0191464114833,-1,-2,-0.15213622291,5,0.0800772928684,tie
24,5,3,9,0.909932659933,7,0.0993907476249,4,8,0.853535353535,1,0.0153106825834,-1,1,0.0563973063973,6,0.0840800650415,different
30,5,3,4,0.452111225541,1,0.0173718122964,4,10,1.0,3,0.056820459426,-1,-6,-0.547888774459,-2,-0.0394486471297,tie
21,4,5,10,1.0,8,0.118498317792,3,8,0.940654843111,0,0.0,2,2,0.0593451568895,8,0.118498317792,tie
21,4,4,10,1.0,8,0.104688198214,5,10,1.0,15,0.0354916445057,-1,0,0.0,-7,0.0691965537087,different
31,6,2,9,0.924309884239,8,0.120164058698,5,8,0.856907894737,1,0.0149581339713,-3,1,0.0674019895018,7,0.105205924727,tie
12,2,4,8,0.871406959153,15,0.175834744023,5,10,1.0,14,0.13268946146,-1,-2,-0.128593040847,1,0.0431452825636,tie
9,1,5,10,1.0,12,0.163309117739,6,10,1.0,15,0.185201648221,-1,0,0.0,-3,-0.0218925304819,different
30,5,3,7,0.843173431734,12,0.226290255468,3,8,0.845195729537,0,0.0,0,-1,-0.00202229780305,12,0.226290255468,different
12,2,5,9,0.933018124507,7,0.122644355975,3,7,0.768206039076,4,0.0724947521395,2,2,0.164812085431,3,0.0501496038355,different
21,4,3,9,0.913430420712,1,0.0136472732522,4,7,0.791366906475,1,0.0145396410145,-1,2,0.122063514237,0,-0.000892367762214,tie
12,1,3,10,1.0,10,0.14219068692,4,7,0.872148541114,10,0.11527176272,-1,3,0.127851458886,0,0.0269189241996,tie
12,2,4,7,0.772321428571,4,0.128569768986,3,5,0.642269736842,4,0.097990430622,1,2,0.130051691729,0,0.0305793383637,different
21,3,2,3,0.382780082988,3,0.0636925604282,3,10,1.0,7,0.0558161838162,-1,-7,-0.617219917012,-4,0.00787637661202,tie
24,4,3,8,0.837940896092,4,0.0677508407724,3,8,0.833969465649,0,0.0,0,0,0.00397143044266,4,0.0677508407724,different
15,3,2,7,0.754335260116,7,0.113753572426,3,9,0.920980926431,1,0.0165205185369,-1,-2,-0.166645666315,6,0.0972330538894,tie
9,2,7,10,1.0,10,0.130816090986,5,10,1.0,7,0.0775403263403,2,0,0.0,3,0.0532757646455,different
9,1,4,10,1.0,6,0.0572272489927,4,10,1.0,10,0.0420237617887,0,0,0.0,-4,0.015203487204,tie
24,5,2,2,0.239106145251,1,0.0188469606031,2,2,0.27950310559,0,0.0,0,0,-0.0403969603387,1,0.0188469606031,different
30,5,1,1,0.140449438202,0,0.0,1,1,0.103092783505,0,0.0,0,0,0.0373566546971,0,0.0,tie
24,5,4,9,0.936802973978,8,0.114376528793,4,8,0.884462151394,7,0.0933816250151,0,1,0.0523408225833,1,0.020994903778,tie
12,2,1,4,0.46088794926,4,0.07132359298,3,4,0.574576271186,1,0.0154144838213,-2,0,-0.113688321926,3,0.0559091091588,different
30,4,1,3,0.354663774403,3,0.0548851293051,2,5,0.547346514048,0,0.0,-1,-2,-0.192682739644,3,0.0548851293051,tie
21,5,3,7,0.771828665568,10,0.151543638958,4,9,0.858321870702,4,0.0626716576093,-1,-2,-0.0864932051331,6,0.0888719813488,tie
21,4,2,8,0.860655737705,11,0.178635200195,3,9,0.933890577508,10,0.151699364465,-1,-1,-0.0732348398027,1,0.0269358357297,tie
18,4,4,10,1.0,11,0.147128547226,5,10,1.0,11,0.162316546763,-1,0,0.0,0,-0.0151879995362,tie
15,2,3,9,0.908075601375,7,0.10144004139,3,10,1.0,0,0.0,0,-1,-0.0919243986254,7,0.10144004139,tie
15,3,4,10,1.0,13,0.196240702664,6,9,0.9496996997,6,0.088594048594,-2,1,0.0503003003003,7,0.10764665407,different
30,5,2,2,0.289446185998,1,0.0176259453916,2,8,0.841240875912,0,0.0,0,-6,-0.551794689914,1,0.0176259453916,tie
27,5,3,8,0.817561807332,6,0.0893492680732,2,7,0.828436018957,0,0.0,1,1,-0.0108742116257,6,0.0893492680732,tie
24,4,3,9,0.926343154246,7,0.11791054873,3,10,1.0,2,0.0280562448304,0,-1,-0.0736568457539,5,0.0898543038994,tie
15,2,3,9,0.93871665465,10,0.129398584305,5,7,0.892725030826,8,0.14578186302,-2,2,0.0459916238242,2,-0.0163832787147,different
16,3,5,9,0.93628185907,12,0.153087954164,5,9,0.936217008798,7,0.125203945615,0,0,6.48502728109e-05,5,0.0278840085497,tie
12,2,6,7,0.778067885117,1,0.0146806177022,3,8,0.86724137931,0,0.0,3,-1,-0.0891734941929,1,0.0146806177022,different
19,4,2,8,0.835193133047,4,0.0579159819391,2,7,0.766338406446,0,0.0,0,1,0.0688547266014,4,0.0579159819391,tie
19,4,3,4,0.457051961824,2,0.0357752486528,3,8,0.865619546248,1,0.015871807076,0,-4,-0.408567584424,1,0.0199034415768,different
15,2,3,5,0.582317073171,2,0.0342846132922,3,6,0.702054794521,2,0.0311457036115,0,-1,-0.11973772135,0,0.00313890968077,tie
12,2,6,10,1.0,13,0.171483944551,8,10,1.0,11,0.179693817822,-2,0,0.0,2,-0.00820987327068,different
21,4,2,4,0.459745762712,3,0.0536060267154,3,6,0.635602094241,0,0.0,-1,-2,-0.175856331529,3,0.0536060267154,tie
15,3,2,5,0.577534791252,4,0.0670697007546,2,8,0.848563968668,0,0.0,0,-3,-0.271029177416,4,0.0670697007546,tie
21,4,3,7,0.791361043195,6,0.0912825733269,4,8,0.834127740705,3,0.0517895831528,-1,-1,-0.0427666975106,3,0.0394929901741,tie
30,4,3,4,0.509615384615,1,0.0162192593652,1,1,0.185223725286,0,0.0,2,3,0.324391659329,1,0.0162192593652,tie
21,4,3,4,0.490509490509,2,0.0337023571224,3,4,0.572131147541,1,0.0149090909091,0,0,-0.0816216570315,1,0.0187932662133,different
21,3,2,8,0.847806624888,3,0.0453035713691,3,5,0.620311070448,1,0.0166414372453,-1,3,0.22749555444,2,0.0286621341239,different
18,3,4,10,1.0,13,0.166904966161,4,9,0.939750692521,9,0.118942331906,0,1,0.0602493074792,4,0.0479626342552,tie
54,9,1,1,0.177419354839,0,0.0,2,3,0.384226491405,0,0.0,-1,-2,-0.206807136567,0,0.0,tie
12,2,4,5,0.54939516129,4,0.0716437822281,4,7,0.803759398496,5,0.0750512645249,0,-2,-0.254364237206,-1,-0.00340748229686,tie
11,2,3,6,0.682969432314,11,0.184800571419,3,7,0.763800904977,0,0.0,0,-1,-0.080831472663,11,0.184800571419,tie
26,5,3,9,0.928027095682,13,0.175887424494,3,10,1.0,7,0.122644628099,0,-1,-0.0719729043184,6,0.0532427963946,tie
17,5,4,9,0.911861614498,10,0.151543638958,5,8,0.841530054645,1,0.0165656565657,-1,1,0.0703315598527,9,0.134977982392,tie
12,2,4,6,0.676496872207,1,0.0150741999462,5,7,0.795133437991,1,0.01427715142,-1,-1,-0.118636565783,0,0.000797048526173,different
9,1,4,6,0.706136560069,7,0.121897420903,5,7,0.868975903614,3,0.0895399780942,-1,-1,-0.162839343545,4,0.0323574428091,tie
39,8,1,3,0.404404404404,0,0.0,2,5,0.581328200192,0,0.0,-1,-2,-0.176923795788,0,0.0,tie
12,2,3,5,0.597918637654,3,0.0512796615236,3,4,0.640495867769,1,0.0125269221137,0,1,-0.0425772301149,2,0.0387527394099,tie
12,2,5,10,1.0,23,0.226986662203,6,10,1.0,7,0.101318491033,-1,0,0.0,16,0.12566817117,tie
24,3,2,4,0.504373177843,8,0.13613390125,3,6,0.678075855689,4,0.110227903456,-1,-2,-0.173702677847,4,0.025905997794,tie
17,3,1,1,0.124571428571,1,0.019277748274,4,7,0.739260739261,0,0.0,-3,-6,-0.614689310689,1,0.019277748274,different
24,3,3,5,0.609015639374,7,0.121867764695,4,6,0.621739130435,0,0.0,-1,-1,-0.0127234910604,7,0.121867764695,tie
17,4,3,4,0.469430051813,4,0.0736483232852,3,9,0.918539325843,0,0.0,0,-5,-0.449109274029,4,0.0736483232852,tie
11,3,5,9,0.935213414634,10,0.140566914498,4,8,0.864274570983,5,0.07786129627,1,1,0.0709388436513,5,0.0627056182281,different
18,4,2,5,0.54012345679,0,0.0,4,7,0.770044052863,0,0.0,-2,-2,-0.229920596073,0,0.0,different
28,4,2,4,0.522471910112,3,0.0473821060106,4,5,0.620087336245,1,0.0158856689162,-2,-1,-0.0976154261322,2,0.0314964370944,tie
13,2,6,10,1.0,7,0.0912121322293,4,10,1.0,4,0.0545889900899,2,0,0.0,3,0.0366231421394,different
30,4,2,3,0.39898989899,0,0.0,2,3,0.384226491405,0,0.0,0,0,0.0147634075844,0,0.0,different
12,2,1,10,1.0,13,0.200652379911,3,10,1.0,1,0.0155861961517,-2,0,0.0,12,0.185066183759,different
32,6,4,7,0.790886899919,9,0.135969038206,4,8,0.847902097902,0,0.0,0,-1,-0.0570151979835,9,0.135969038206,different
24,6,4,7,0.785353535354,8,0.126462894121,5,10,1.0,1,0.0162113109707,-1,-3,-0.214646464646,7,0.11025158315,tie
40,6,2,2,0.286910994764,1,0.0176628583663,2,4,0.461855670103,0,0.0,0,-2,-0.174944675339,1,0.0176628583663,tie
24,5,3,3,0.404404404404,1,0.0168849146544,5,9,0.929440389294,1,0.0147518985475,-2,-6,-0.52503598489,0,0.00213301610691,tie
27,3,4,8,0.844748858447,4,0.068190999983,2,5,0.559915164369,0,0.0,2,3,0.284833694078,4,0.068190999983,different
21,5,5,6,0.715719063545,7,0.125993087242,4,9,0.933486238532,2,0.040594940228,1,-3,-0.217767174987,5,0.0853981470145,tie
15,2,3,9,0.934965570008,16,0.252736907075,6,7,0.79593432369,9,0.160017058782,-3,2,0.139031246317,7,0.0927198482929,different
24,4,3,7,0.779602420052,9,0.144430378527,3,4,0.500956022945,4,0.0780392838519,0,3,0.278646397107,5,0.0663910946748,different
36,6,3,7,0.783347493628,9,0.14732654692,3,5,0.724928366762,0,0.0,0,2,0.0584191268657,9,0.14732654692,tie
24,4,3,7,0.770609318996,6,0.0971372799829,2,6,0.683923705722,1,0.0276013541409,1,1,0.0866856132743,5,0.0695359258421,tie
21,2,3,3,0.455626715462,1,0.0154327810977,3,4,0.538869257951,1,0.0160681015098,0,-1,-0.0832425424885,0,-0.000635320412106,different
15,3,4,10,1.0,8,0.152007131815,4,5,0.651442307692,3,0.0762427156177,0,5,0.348557692308,5,0.0757644161968,different
27,4,3,8,0.852045256745,10,0.156201772351,2,4,0.542506573181,4,0.0715417098239,1,4,0.309538683564,6,0.084660062527,tie
26,5,3,5,0.556859205776,3,0.0456715606673,3,8,0.85328836425,4,0.0833972098728,0,-3,-0.296429158473,-1,-0.0377256492055,tie
27,4,2,5,0.538545059718,2,0.0366298148529,5,8,0.858536585366,1,0.0147878787879,-3,-3,-0.319991525648,1,0.0218419360651,different
16,3,3,7,0.754098360656,7,0.113863267289,2,8,0.8536121673,0,0.0,1,-1,-0.0995138066446,7,0.113863267289,tie
15,2,4,10,1.0,12,0.190825734868,6,9,0.940206185567,8,0.145560762262,-2,1,0.059793814433,4,0.0452649726065,different
15,2,6,9,0.946574481458,9,0.178956210468,5,9,0.96660268714,25,0.156898970511,1,0,-0.0200282056819,-16,0.022057239957,tie
28,6,5,10,1.0,9,0.126013041036,4,8,0.820618556701,1,0.0187516401125,1,2,0.179381443299,8,0.107261400923,tie
10,3,5,8,0.855421686747,8,0.123461783939,5,7,0.791533546326,1,0.0145280278827,0,1,0.0638881404211,7,0.108933756056,different
29,6,4,10,1.0,11,0.162512337398,5,10,1.0,13,0.154903908443,-1,0,0.0,-2,0.00760842895443,tie
14,4,5,8,0.859620148637,8,0.138361488094,4,9,0.933076923077,7,0.114151048951,1,-1,-0.0734567744394,1,0.0242104391429,different
28,5,3,4,0.456289978678,2,0.0359659482724,2,3,0.411594202899,0,0.0,1,1,0.0446957757795,2,0.0359659482724,tie
9,1,6,7,0.771224307417,4,0.0727581384069,5,9,0.934487951807,2,0.0460761226725,1,-2,-0.16326364439,2,0.0266820157344,tie
36,5,2,7,0.775922671353,9,0.158699799426,5,8,0.876701361089,5,0.0799184802387,-3,-1,-0.100778689736,4,0.0787813191876,different
21,2,4,10,1.0,8,0.109231443339,4,9,0.934880239521,5,0.0695536200327,0,1,0.065119760479,3,0.0396778233066,tie
15,3,3,9,0.937865497076,2,0.0272913541599,5,9,0.936681222707,3,0.0758290326849,-2,0,0.0011842743686,-1,-0.0485376785251,tie
9,1,4,6,0.677998111426,5,0.0768189812231,6,8,0.873730043541,4,0.0930188679245,-2,-2,-0.195731932115,1,-0.0161998867014,tie
39,6,4,5,0.645242070117,1,0.0140801583804,2,4,0.538314176245,0,0.0,2,1,0.106927893872,1,0.0140801583804,different
12,2,5,10,1.0,9,0.128191496449,6,9,0.931657501964,5,0.0881011211883,-1,1,0.0683424980361,4,0.0400903752608,tie
12,2,2,4,0.485887096774,7,0.127347778511,2,3,0.340195016251,0,0.0,0,1,0.145692080523,7,0.127347778511,different
15,2,4,7,0.793522267206,6,0.14500699848,5,5,0.654615881214,3,0.0908832677974,-1,2,0.138906385993,3,0.0541237306825,different
12,2,6,8,0.890675241158,3,0.113480916578,6,7,0.816842105263,2,0.0610449760766,0,1,0.0738331358944,1,0.0524359405015,different
13,2,3,7,0.785201149425,5,0.0663229607315,3,9,0.943579766537,5,0.0647329324372,0,-2,-0.158378617112,0,0.00159002829432,tie
9,1,6,7,0.808558558559,10,0.132288422251,5,7,0.844735276621,15,0.184365855512,1,0,-0.0361767180625,-5,-0.0520774332605,different
12,2,5,8,0.878658101356,16,0.223536560449,7,9,0.940123881624,12,0.184992804855,-2,-1,-0.0614657802681,4,0.0385437555942,tie
24,3,3,6,0.668292682927,3,0.0493698431408,5,6,0.696335078534,0,0.0,-2,0,-0.0280423956072,3,0.0493698431408,tie
30,6,2,2,0.393398751115,1,0.00448351677505,2,3,0.405650857719,0,0.0,0,-1,-0.0122521066044,1,0.00448351677505,tie
29,6,4,8,0.878310665712,7,0.0989281333074,2,7,0.740814299901,4,0.081061659294,2,1,0.137496365812,3,0.0178664740134,tie
15,2,7,10,1.0,18,0.232381052195,6,10,1.0,3,0.038403021311,1,0,0.0,15,0.193978030884,different
21,4,1,2,0.268817204301,0,0.0,3,8,0.846830985915,0,0.0,-2,-6,-0.578013781614,0,0.0,tie
43,7,2,5,0.610449129239,8,0.140180387694,3,7,0.858325666973,0,0.0,-1,-2,-0.247876537734,8,0.140180387694,tie
36,9,3,3,0.434410646388,1,0.0160342488021,1,5,0.575609756098,0,0.0,2,-2,-0.14119910971,1,0.0160342488021,different
24,2,5,10,1.0,11,0.134971699098,4,8,0.873146622735,5,0.0822225550397,1,2,0.126853377265,6,0.0527491440584,different
24,3,3,4,0.493557978196,3,0.0537191300599,4,5,0.552929085303,0,0.0,-1,-1,-0.059371107107,3,0.0537191300599,tie
26,3,3,7,0.767123287671,6,0.0957138734701,4,8,0.851788756388,1,0.0154932631253,-1,-1,-0.0846654687172,5,0.0802206103449,different
12,2,4,10,1.0,17,0.200087992007,6,10,1.0,8,0.115467720685,-2,0,0.0,9,0.0846202713221,tie
33,5,3,8,0.873699851412,20,0.213213321034,5,10,1.0,6,0.121016746411,-2,-2,-0.126300148588,14,0.0921965746223,different
27,4,5,10,1.0,13,0.183415943825,5,10,1.0,2,0.0304761904762,0,0,0.0,11,0.152939753349,different
27,4,3,6,0.761235955056,11,0.238963754647,2,5,0.531754574812,0,0.0,1,1,0.229481380245,11,0.238963754647,tie
24,4,4,8,0.850746268657,2,0.0424539232549,3,7,0.767172167707,0,0.0,1,1,0.0835741009493,2,0.0424539232549,different
12,2,4,7,0.754867256637,5,0.133838865678,5,5,0.659624413146,1,0.0142324655001,-1,2,0.0952428434916,4,0.119606400177,different
12,2,3,5,0.587638376384,3,0.0466827391322,2,6,0.698440207972,0,0.0,1,-1,-0.110801831589,3,0.0466827391322,tie
24,4,4,7,0.772117962466,4,0.169555265422,4,5,0.63456284153,3,0.0912232985594,0,2,0.137555120936,1,0.0783319668628,different
28,5,2,4,0.506292352372,0,0.0,3,4,0.488235294118,1,0.0178324420677,-1,0,0.0180570582541,-1,-0.0178324420677,tie
18,3,6,8,0.871698113208,8,0.185160973557,4,5,0.728760717069,5,0.159875292284,2,3,0.142937396138,3,0.0252856812731,different
26,5,4,4,0.488465396189,1,0.0169187860981,3,4,0.55612244898,1,0.0154669140383,1,0,-0.067657052791,0,0.00145187205973,tie
15,2,4,10,1.0,5,0.0768125215837,6,7,0.871301775148,4,0.0881334050565,-2,3,0.128698224852,1,-0.0113208834728,tie
27,5,4,10,1.0,2,0.031964531242,5,8,0.858651502843,4,0.101215567536,-1,2,0.141348497157,-2,-0.0692510362936,tie
15,2,3,5,0.62389380531,1,0.0181119847353,3,8,0.893382352941,5,0.06875557041,0,-3,-0.269488547631,-4,-0.0506435856746,tie
15,3,5,8,0.877785765636,9,0.125386512872,5,9,0.943762120233,1,0.0117576541106,0,-1,-0.0659763545965,8,0.113628858762,different
18,3,4,10,1.0,13,0.211515169685,3,7,0.777493606138,9,0.185237541657,1,3,0.222506393862,4,0.0262776280276,different
30,6,4,9,0.94907130018,20,0.29173692147,3,8,0.819875776398,1,0.0188292866554,1,1,0.129195523782,19,0.272907634814,different
21,5,2,5,0.553333333333,4,0.0642591609134,5,8,0.858455882353,0,0.0,-3,-3,-0.30512254902,4,0.0642591609134,tie
18,4,3,7,0.755731922399,2,0.032922903431,3,8,0.830409356725,0,0.0,0,-1,-0.0746774343266,2,0.032922903431,different
21,3,3,7,0.774136403897,5,0.074703408945,2,9,0.91922005571,0,0.0,1,-2,-0.145083651813,5,0.074703408945,tie
21,4,3,8,0.851268591426,8,0.138234347101,2,4,0.508474576271,0,0.0,1,4,0.342794015155,8,0.138234347101,tie
27,6,1,1,0.139821029083,0,0.0,1,2,0.210280373832,0,0.0,0,-1,-0.070459344749,0,0.0,tie
15,2,5,8,0.866457187745,9,0.140456492727,5,10,1.0,1,0.0151702176056,0,-2,-0.133542812255,8,0.125286275122,tie
18,4,4,9,0.932486100079,8,0.120311452708,5,6,0.523923444976,2,0.0308829926055,-1,3,0.408562655103,6,0.0894284601023,different
30,6,5,9,0.935849056604,16,0.207397068107,5,8,0.868778280543,1,0.013717263129,0,1,0.0670707760608,15,0.193679804978,tie
9,1,6,10,1.0,16,0.184939187005,4,9,0.953525641026,17,0.181482128982,2,1,0.0464743589744,-1,0.00345705802288,different
21,4,1,1,0.159340659341,0,0.0,3,5,0.602739726027,1,0.0166110419261,-2,-4,-0.443399066687,-1,-0.0166110419261,tie
24,3,4,5,0.614687216682,3,0.055258217703,5,9,0.926020408163,2,0.0309338280767,-1,-4,-0.311333191481,1,0.0243243896263,tie
18,3,6,9,0.943029490617,7,0.0902172179754,4,8,0.874368231047,3,0.0418510009846,2,1,0.0686612595697,4,0.0483662169908,different
15,3,2,4,0.475847893114,0,0.0,4,6,0.737556561086,1,0.013717263129,-2,-2,-0.261708667972,-1,-0.013717263129,tie
12,3,3,5,0.622222222222,3,0.0611747211896,2,4,0.48418972332,0,0.0,1,1,0.138032498902,3,0.0611747211896,tie
27,5,2,3,0.351890756303,0,0.0,2,2,0.282474226804,1,0.0187516401125,0,1,0.0694165294984,-1,-0.0187516401125,tie
27,4,4,9,0.929810074319,9,0.137990047857,4,9,0.926952141058,1,0.0152721166323,0,0,0.00285793326081,8,0.122717931225,tie
24,4,2,6,0.655521783181,5,0.085451011853,4,5,0.616063548102,1,0.016053919602,-2,1,0.039458235079,4,0.069397092251,tie
12,2,6,8,0.888084265964,11,0.119513424749,5,8,0.905331882481,37,0.0696290434266,1,0,-0.0172476165165,-26,0.0498843813221,different
21,3,4,8,0.876722262509,8,0.127702850242,4,7,0.80680977054,4,0.0769019581455,0,1,0.0699124919687,4,0.0508008920962,different
27,4,4,9,0.922445255474,8,0.129690934252,3,8,0.836170212766,0,0.0,1,1,0.0862750427085,8,0.129690934252,tie
29,5,2,4,0.514285714286,0,0.0,2,2,0.325581395349,0,0.0,0,2,0.188704318937,0,0.0,tie
12,2,4,6,0.700176366843,8,0.123827226058,4,6,0.730650154799,1,0.0140782437377,0,0,-0.0304737879557,7,0.10974898232,tie
24,3,3,8,0.85903814262,9,0.131198098726,3,8,0.789090909091,0,0.0,0,0,0.0699472335293,9,0.131198098726,different
15,5,3,8,0.865671641791,7,0.0954044101543,3,9,0.922872340426,0,0.0,0,-1,-0.0572006986345,7,0.0954044101543,different
24,4,3,7,0.747274529237,6,0.100305429573,3,9,0.913360323887,0,0.0,0,-2,-0.16608579465,6,0.100305429573,different
27,3,3,4,0.542709232097,1,0.014553951458,3,4,0.527173913043,0,0.0,0,0,0.0155353190532,1,0.014553951458,tie
20,4,4,7,0.765055131467,6,0.0988141295471,3,5,0.554759467758,0,0.0,1,2,0.210295663709,6,0.0988141295471,different
15,3,3,4,0.478527607362,2,0.0344949483431,4,5,0.639602319801,1,0.015069669353,-1,-1,-0.161074712439,1,0.0194252789901,tie
30,5,3,5,0.703832752613,4,0.132217659935,4,6,0.724247226624,2,0.0689295490563,-1,-1,-0.0204144740112,2,0.0632881108792,tie
25,4,4,7,0.779029462738,5,0.092964184701,3,8,0.932400932401,0,0.0,1,-1,-0.153371469663,5,0.092964184701,different
18,3,2,2,0.261744966443,1,0.0188680422145,3,3,0.431568431568,1,0.0181709199891,-1,-1,-0.169823465125,0,0.000697122225414,tie
25,4,2,5,0.559462254395,4,0.0697746835151,4,10,1.0,1,0.0154932631253,-2,-5,-0.440537745605,3,0.0542814203898,tie
24,4,3,5,0.599434495759,2,0.031796474533,3,10,1.0,3,0.0931623931624,0,-5,-0.400565504241,-1,-0.0613659186294,tie
15,3,5,10,1.0,11,0.134238511079,5,9,1.0,0,0.0,0,1,0.0,11,0.134238511079,tie
30,4,2,2,0.344262295082,4,0.0866113646385,2,2,0.294117647059,0,0.0,0,0,0.0501446480231,4,0.0866113646385,tie
15,4,3,5,0.632352941176,4,0.0908577841808,4,6,0.709758131776,1,0.0151702176056,-1,-1,-0.0774051906,3,0.0756875665752,tie
24,4,2,7,0.785714285714,7,0.115477492112,2,8,0.819502074689,0,0.0,0,-1,-0.0337877889745,7,0.115477492112,tie
9,2,5,10,1.0,13,0.20322843568,5,9,0.941689008043,12,0.212449427248,0,1,0.0583109919571,1,-0.00922099156857,different
21,3,2,4,0.46088794926,4,0.07132359298,3,7,0.826231691079,6,0.0800435782593,-1,-3,-0.365343741819,-2,-0.00871998527926,different
36,7,3,6,0.722222222222,0,0.0,4,6,0.680147058824,0,0.0,-1,0,0.0420751633987,0,0.0,tie
30,5,3,5,0.565338276182,3,0.0468990632246,2,8,0.863636363636,0,0.0,1,-3,-0.298298087455,3,0.0468990632246,tie
9,1,4,8,0.862903225806,3,0.0408097493704,4,10,1.0,5,0.0503761557457,0,-2,-0.137096774194,-2,-0.00956640637528,different
26,5,3,3,0.420593368237,5,0.0869405139584,3,9,0.916104146577,0,0.0,0,-6,-0.495510778339,5,0.0869405139584,tie
15,2,2,4,0.458598726115,3,0.0537198399356,2,7,0.739260739261,0,0.0,0,-3,-0.280662013146,3,0.0537198399356,different
9,1,5,6,0.746844840386,4,0.0678555953889,5,5,0.609164420485,1,0.0163423997386,0,1,0.137680419901,3,0.0515131956503,tie
21,3,2,4,0.423728813559,1,0.0231260370067,2,7,0.75023923445,0,0.0,0,-3,-0.32651042089,1,0.0231260370067,tie
30,5,1,1,0.159340659341,0,0.0,1,3,0.370217166494,0,0.0,0,-2,-0.210876507154,0,0.0,tie
12,2,5,10,1.0,10,0.167031578669,6,10,1.0,6,0.126099858691,-1,0,0.0,4,0.0409317199783,tie
18,4,3,10,1.0,15,0.174348373372,6,10,1.0,7,0.092950339585,-3,0,0.0,8,0.0813980337871,tie
16,3,5,9,0.937910883857,9,0.117872921651,5,10,1.0,1,0.0141880584314,0,-1,-0.0620891161432,8,0.103684863219,tie
30,6,2,5,0.568115942029,0,0.0,4,9,0.920692798541,0,0.0,-2,-4,-0.352576856512,0,0.0,tie
21,3,3,7,0.744744744745,6,0.101309487927,6,7,0.800458715596,2,0.0278120656102,-3,0,-0.0557139708516,4,0.0734974223164,tie
26,5,3,9,0.923285198556,8,0.125038583871,4,9,0.916905444126,0,0.0,-1,0,0.00637975442988,8,0.125038583871,tie
22,4,3,9,0.93359375,22,0.242926638011,3,10,1.0,8,0.111620027227,0,-1,-0.06640625,14,0.131306610784,tie
16,3,3,5,0.573126142596,5,0.0927940846659,4,7,0.786590351594,0,0.0,-1,-2,-0.213464208998,5,0.0927940846659,tie
18,3,4,6,0.740853658537,17,0.232380258863,4,5,0.648910411622,4,0.0640927434148,0,1,0.0919432469143,13,0.168287515448,tie
27,4,1,1,0.137061403509,0,0.0,4,7,0.795133437991,1,0.01427715142,-3,-6,-0.658072034482,-1,-0.01427715142,tie
22,4,2,3,0.37891440501,2,0.0352150934025,3,8,0.83738317757,0,0.0,-1,-5,-0.45846877256,2,0.0352150934025,different
28,5,5,8,0.875457875458,5,0.0866674836935,4,9,1.0,2,0.137831961485,1,-1,-0.124542124542,3,-0.0511644777912,different
27,5,1,2,0.241071428571,0,0.0,3,7,0.760330578512,0,0.0,-2,-5,-0.519259149941,0,0.0,different
40,7,2,9,0.921150278293,6,0.0938851376982,3,7,0.829745596869,17,0.163953033268,-1,2,0.0914046814243,-11,-0.0700678955699,tie
29,6,4,5,0.589316987741,5,0.0908713598396,3,7,0.775634517766,0,0.0,1,-2,-0.186317530026,5,0.0908713598396,tie
21,3,2,8,0.845173041894,7,0.107537530217,3,5,0.543546694648,0,0.0,-1,3,0.301626347246,7,0.107537530217,tie
15,2,4,7,0.790296052632,8,0.13316865584,4,7,0.79593432369,5,0.0780439263629,0,0,-0.0056382710588,3,0.0551247294774,tie
25,5,1,2,0.240352811466,2,0.0371952144207,2,4,0.486220472441,0,0.0,-1,-2,-0.245867660975,2,0.0371952144207,tie
18,3,3,6,0.701073492981,13,0.200316798615,6,10,1.0,1,0.0145745920746,-3,-4,-0.298926507019,12,0.18574220654,tie
18,2,3,6,0.642290748899,4,0.059446800845,3,9,0.933128362798,1,0.0139808538886,0,-3,-0.290837613899,3,0.0454659469564,tie
24,4,3,7,0.752906976744,6,0.10155687156,3,9,0.91577928364,0,0.0,0,-2,-0.162872306896,6,0.10155687156,tie
21,4,5,8,0.866666666667,4,0.0529193089875,4,9,0.925577416595,1,0.0155595302901,1,-1,-0.0589107499287,3,0.0373597786975,tie
12,2,4,6,0.675881792183,4,0.07825650912,5,9,0.918123275069,1,0.00716768837035,-1,-3,-0.242241482886,3,0.0710888207497,different
33,5,1,2,0.24276169265,2,0.0375679949661,3,4,0.502857142857,2,0.0346458874459,-2,-2,-0.260095450207,0,0.00292210752021,tie
9,2,4,6,0.697508896797,6,0.0875391922105,4,7,0.826368876081,1,0.0131045323553,0,-1,-0.128859979284,5,0.0744346598553,different
15,3,2,5,0.577114427861,3,0.0503523275814,4,9,0.923884514436,0,0.0,-2,-4,-0.346770086575,3,0.0503523275814,tie
22,5,1,4,0.450746268657,4,0.0671364367752,4,8,0.864591439689,1,0.0236490979837,-3,-4,-0.413845171032,3,0.0434873387915,different
25,4,4,8,0.860655737705,11,0.167574197087,4,7,0.752606635071,3,0.0485170185265,0,1,0.108049102634,8,0.11905717856,tie
33,5,4,9,0.931561996779,5,0.0823934893355,4,8,0.89364640884,7,0.0971220492215,0,1,0.0379155879396,-2,-0.014728559886,different
12,2,3,5,0.606481481481,3,0.060391711414,3,5,0.547817047817,0,0.0,0,0,0.0586644336644,3,0.060391711414,tie
24,5,7,10,1.0,11,0.141966392789,3,9,0.920692798541,1,0.0165807574376,4,1,0.0793072014585,10,0.125385635352,different
21,5,1,10,1.0,10,0.155037038049,2,3,0.393426294821,3,0.11152662079,-1,7,0.606573705179,7,0.0435104172599,tie
12,2,5,6,0.707532051282,10,0.168821787723,4,9,0.925257731959,0,0.0,1,-3,-0.217725680677,10,0.168821787723,tie
12,1,5,10,1.0,17,0.224777114109,5,10,1.0,10,0.152318154616,0,0,0.0,7,0.072458959493,tie
15,3,3,8,0.862903225806,3,0.0495158292361,3,7,0.755388940956,0,0.0,0,1,0.107514284851,3,0.0495158292361,different
12,2,6,9,0.927101200686,11,0.186364592832,5,10,1.0,5,0.0943849453438,1,-1,-0.0728987993139,6,0.0919796474877,different
9,1,6,9,0.933385579937,9,0.128732039016,6,9,0.946163366337,8,0.159178667867,0,0,-0.0127777863993,1,-0.0304466288508,tie
15,2,2,6,0.686346863469,7,0.132164021454,4,8,0.868975903614,6,0.0905312157722,-2,-2,-0.182629040146,1,0.0416328056822,tie
12,1,6,6,0.708064516129,6,0.150899388416,5,9,0.943025540275,11,0.172412930881,1,-3,-0.234961024146,-5,-0.0215135424646,different
9,2,4,5,0.600563909774,3,0.0475602342287,4,5,0.632290786137,2,0.0307507876739,0,0,-0.0317268763625,1,0.0168094465548,tie
27,5,2,10,1.0,12,0.195074275624,4,8,0.864274570983,6,0.0937796057297,-2,2,0.135725429017,6,0.101294669895,tie
12,2,4,9,0.934730538922,12,0.141139282773,4,10,1.0,7,0.0754774261957,0,-1,-0.0652694610778,5,0.0656618565771,different
29,5,2,7,0.755980861244,7,0.119878693015,3,8,0.866319444444,1,0.0157891414141,-1,-1,-0.1103385832,6,0.104089551601,tie
15,2,5,10,1.0,21,0.236655469284,7,10,1.0,5,0.10501878287,-2,0,0.0,16,0.131636686414,tie
15,3,6,10,1.0,11,0.1490250956,6,9,0.943834732085,10,0.127073185046,0,1,0.0561652679148,1,0.0219519105537,different
25,5,2,6,0.663699307616,5,0.0834225011858,3,6,0.689285714286,2,0.0324805194805,-1,0,-0.0255864066695,3,0.0509419817053,tie
16,3,3,10,1.0,7,0.0873795842865,6,7,0.796280642434,3,0.0347928994083,-3,3,0.203719357566,4,0.0525866848782,different
12,1,5,9,0.939285714286,3,0.0525318640467,5,8,0.934782608696,0,0.0,0,1,0.00450310559006,3,0.0525318640467,different
24,4,2,2,0.301229508197,0,0.0,4,4,0.567880794702,5,0.00534166164961,-2,-2,-0.266651286505,-5,-0.00534166164961,different
33,6,2,8,0.856071964018,1,0.0153422359452,5,9,0.934140802422,5,0.113126419379,-3,-1,-0.0780688384044,-4,-0.097784183434,different
9,2,7,10,1.0,14,0.167900993017,5,9,0.948763250883,14,0.163229467823,2,1,0.0512367491166,0,0.00467152519365,tie
18,4,3,7,0.774250440917,10,0.153576837592,2,9,0.913776015857,0,0.0,1,-2,-0.13952557494,10,0.153576837592,tie
32,7,2,3,0.427419354839,12,0.217485443232,4,9,0.93453724605,1,0.0136862986524,-2,-6,-0.507117891211,11,0.203799144579,different
12,2,2,2,0.314516129032,2,0.101445392133,3,4,0.55,2,0.0749905956113,-1,-2,-0.235483870968,0,0.0264547965221,different
18,3,3,5,0.593690248566,4,0.0713854158522,4,4,0.444680851064,0,0.0,-1,1,0.149009397502,4,0.0713854158522,different
15,3,3,8,0.860408163265,14,0.217610196495,3,7,0.797674418605,10,0.177933756166,0,1,0.0627337446607,4,0.0396764403286,tie
9,2,3,8,0.841713221601,6,0.10386769399,5,9,0.936773255814,0,0.0,-2,-1,-0.0950600342125,6,0.10386769399,tie
12,1,5,8,0.871309613929,7,0.101472073933,3,8,0.874277456647,4,0.0650052548607,2,0,-0.00296784271856,3,0.0364668190722,tie
27,4,2,4,0.493041749503,4,0.0816014692514,3,5,0.53276047261,0,0.0,-1,-1,-0.0397187231071,4,0.0816014692514,tie
24,4,1,5,0.611313868613,0,0.0,1,1,0.103092783505,0,0.0,0,4,0.508221085108,0,0.0,tie
21,4,3,4,0.457696228338,7,0.0859452269704,4,6,0.723370429253,9,0.0987483740425,-1,-2,-0.265674200914,-2,-0.0128031470721,tie
12,2,3,5,0.580867850099,3,0.0534542428309,4,8,0.858880778589,1,0.0147518985475,-1,-3,-0.27801292849,2,0.0387023442833,different
27,5,2,9,0.932,0,0.0,2,3,0.479041916168,0,0.0,0,6,0.452958083832,0,0.0,tie
27,5,4,5,0.569778633301,3,0.0627748299587,3,4,0.527687296417,1,0.0167091106505,1,1,0.0420913368843,2,0.0460657193083,tie
21,3,3,9,0.923146473779,11,0.172764979127,5,9,0.936170212766,10,0.173573000734,-2,0,-0.0130237389866,1,-0.000808021606643,different
